ieduleen	iedereen	replacement	7
lettu	redden	replacement	7
uitkijktoolu	uitkijktoren	replacement	7
saafu	graven	replacement	7
o	op	noncompletion	13
wate	water	noncompletion	7
siesu	vliegen	replacement	7
hee	weer	replacement	8
hee	heel	noncompletion	7
hee	heef	noncompletion	12
hee	een	replacement	6
had	gehad	replacement	3
had	kon	replacement	6
had	hard	noncompletion	14
tuk	stuk	replacement	3
tuk	stuk	noncompletion	7
tuk	stuk	explanation	12
leen	alleen	replacement	10
leen	aleen	noncompletion	7
gun	ging	replacement	7
gin	ging	noncompletion	13
mij	mijn	noncompletion	55
som	soms	noncompletion	21
witte	wit	replacement	7
dee	was	replacement	7
dan	toen	replacement	26
ging	gingen	replacement	7
Cas	Cars	noncompletion	28
heb	heet	replacement	6
heb	heeft	replacement	12
heb	hebt	noncompletion	24
heb	hebben	replacement	13
heb	is	replacement	6
speeloet	speelgoed	replacement	7
Cwas	Cwars	noncompletion	7
daa	daar	noncompletion	88
siend	vriend	replacement	7
hoo	hoor	noncompletion	7
debij	derbij	noncompletion	19
i	is	replacement	3
i	ik	noncompletion	82
i	is	noncompletion	15
wuw	wil	replacement	7
Eipet	iPad	replacement	7
om	op	replacement	7
mat	mag het	replacement	7
Ensu	Enzo	replacement	7
Slow	Knol	replacement	7
pulletjes	spulletjes	noncompletion	7
hellu	willen	replacement	7
teesjut	tieshirt	replacement	7
dikku	sticker	replacement	7
tan	dan	replacement	9
tan	kan	replacement	21
soe	zo	replacement	7
heew	heel	replacement	27
Misjie	Marshall	replacement	7
Pot	Porter	replacement	7
ky	Sky	noncompletion	7
mee	gaat hij mee	explanation	3
mee	met	replacement	3
mee	meer	noncompletion	19
sewf	zelf	replacement	7
sas	zag	replacement	14
lew	wel	replacement	7
slin	ging	replacement	7
de	het	replacement	94
de	der	noncompletion	49
de	dan	replacement	8
de	deze	replacement	12
stond	stonden	replacement	14
stond	was	replacement	6
van	door	replacement	4
van	met	replacement	4
van	uit	replacement	4
van	veel	replacement	4
van	bij	replacement	6
van	om	replacement	6
arreen	alleen	replacement	6
het	hij	replacement	4
het	er	replacement	6
maar	ga daar maar	explanation	3
maar	en	replacement	24
maar	want	replacement	6
jiggen	liggen	replacement	12
kruisd	gekruisd	replacement	6
jit	ligt	replacement	6
riggen	liggen	replacement	6
hel	wel	replacement	6
rigt	ligt	replacement	6
die	dat	replacement	7
die	het	replacement	4
die	ze	replacement	6
die	hij	replacement	12
die	daar	replacement	10
mog	nog	replacement	6
harders	harder	replacement	6
is	gaat	replacement	6
allerlangzaam	allerlangzaamste	replacement	6
his	wist	replacement	6
bij	voor	replacement	6
bij	op	replacement	6
sumdat	voordat	replacement	6
u	hij	replacement	6
u	het	replacement	18
u	op	replacement	6
u	ik	replacement	18
u	een	replacement	18
nieuw	nieuwe	noncompletion	6
gezon	gezonde	replacement	6
moes	moest	noncompletion	40
deze	dit	replacement	9
deze	waar hoort deze	explanation	12
rege	leeg	replacement	6
denk	denkt	noncompletion	6
opgeten	opgegeten	replacement	6
e	de	noncompletion	30
e	het	noncompletion	12
e	er	noncompletion	34
e	en	noncompletion	20
e	een	noncompletion	12
e	'n	replacement	24
e	even	explanation	12
e	ze	noncompletion	12
kunnen	kan	replacement	6
gingen	ging	replacement	12
da	dat	noncompletion	313
da	dan	noncompletion	30
da	te	replacement	6
da	daar	noncompletion	6
doen	duikelen	replacement	6
slur	slurf	noncompletion	6
op	in	replacement	6
op	erop	explanation	12
op	erop	replacement	6
badje	zwemmen	replacement	6
verkopen	vragen	replacement	6
voetbalmeester	trainer	replacement	12
gaat	laat	replacement	8
gaat	zegt	replacement	6
gaat	ga	replacement	6
daar	waar	replacement	8
daar	dan	replacement	6
daar	gaat	replacement	6
twemle	twemles	noncompletion	6
twemles	zwemles	replacement	6
poberen	proberen	noncompletion	6
vliegen	fladderen	replacement	6
as	als	noncompletion	6
as	dat	replacement	6
echt	echte	noncompletion	12
gezie	gezien	noncompletion	6
vader	vaders	noncompletion	6
hoger	ouder	replacement	6
net	met	replacement	16
datte	wat	replacement	6
moet	moeten	replacement	12
als	of	replacement	4
als	waarmee	replacement	6
hardte	hardste	noncompletion	6
moe	moet	noncompletion	57
want	en	replacement	4
want	als	replacement	6
gaan	gegaan	replacement	4
gaan	gingen	replacement	6
me	met	noncompletion	6
me	maar	replacement	6
me	mijn	explanation	12
me	we	explanation	36
me	we	replacement	48
slaapten	sliepen	replacement	12
slaapte	sliep	replacement	6
zaten	hadden	replacement	6
zo	zo'n	replacement	6
ook	blauwe ramen zitten er ook	explanation	6
ginnen	gingen	replacement	12
dat	het	replacement	6
allegrooste	allegrootste	noncompletion	12
en	eng	noncompletion	3
en	maar	replacement	7
en	want	replacement	12
ben	wordt	replacement	12
pupcakes	cupcakes	replacement	6
pupcakedingetjes	cupcakedingetjes	replacement	6
ee	een	noncompletion	48
vom	vorm	noncompletion	12
doet	doe	replacement	6
ga	gaat	noncompletion	6
ga	gaan	replacement	18
ga	gaat	replacement	6
lus	lust	noncompletion	12
babykijn	babykonijn	replacement	6
babynijn	babykonijn	replacement	6
poep	poept	noncompletion	6
kinderboererij	kinderboerderij	noncompletion	6
vin	vind	noncompletion	9
vin	vindt	noncompletion	12
kinerboererij	kinderboerderij	noncompletion	6
woon	gewoon	replacement	6
blijf	blijft	noncompletion	6
tof	toch	replacement	12
blijven	blijft	replacement	6
sieten	sgieten	noncompletion	6
ie	gaat ie	explanation	3
ie	hij	replacement	129
ie	die	noncompletion	20
ie	in	replacement	6
ie	de	replacement	12
ie	de	explanation	12
ta	tat	noncompletion	6
peltje	pijltje	replacement	6
pijwtje	pijltje	replacement	6
sef	zeg	replacement	6
doe	ga	replacement	6
zwaarden	vechten	replacement	6
nie	Leonie	noncompletion	3
nie	niet	noncompletion	87
lekkes	lekkers	noncompletion	6
was	waren	replacement	4
was	wat	replacement	6
suimpjes	sguimpjes	noncompletion	6
foot	grote	replacement	6
foot	groot	replacement	6
fa	van	replacement	3
fa	fan	noncompletion	6
fan	als	replacement	6
suimpje	sguimpje	noncompletion	18
hebt	heeft	replacement	16
hebt	heb	replacement	6
maa	maar	noncompletion	32
maa	maak	noncompletion	6
flij	vrij	replacement	6
lekke	lekker	noncompletion	6
sool	sgool	noncompletion	6
weken	werken	noncompletion	6
allee	alleen	noncompletion	6
kleulen	kleuren	replacement	6
paadje	paardje	noncompletion	12
paatje	paartje	noncompletion	6
sintetlaaspaatje	sinterklaaspaardje	replacement	6
Zwatepiet	Zwartepiet	noncompletion	6
saf	staf	noncompletion	6
kippes	kippies	replacement	6
itten	eten	replacement	6
ziekje	muziekje	replacement	6
Bobdebouwerkattet	Bobdebouwerkwartet	replacement	6
blazen	geblazen	replacement	6
ik	mij	replacement	6
naan	banaan	explanation	12
es	eens	noncompletion	438
s	is	noncompletion	330
t	het	noncompletion	1056
t	met	noncompletion	3
m	hem	noncompletion	126
wilt	wil	replacement	12
taan	staan	explanation	12
in	deze	replacement	3
in	op	replacement	9
in	erin	noncompletion	12
in	uit	replacement	6
in	erin	replacement	6
in	bij	replacement	6
jijjen	rijden	replacement	12
zn	zijn	noncompletion	48
kan	kunnen	replacement	4
kan	kam	explanation	12
kan	dan	replacement	12
k	ik	noncompletion	62
maken	aan elkaar	explanation	12
hu	pronoun	explanation	12
man	de kassier	explanation	12
toe	toen	noncompletion	4
toe	sg	explanation	12
toe	doe	replacement	6
leeuw	leeuwe	noncompletion	12
oot	ook	explanation	12
oot	ook	replacement	6
ditte	dit	replacement	12
d'aan	eraan	replacement	12
brbrbrbr	motorgeluiden	explanation	12
mn	mijn	noncompletion	72
omt	komt	explanation	24
an	kan	explanation	12
kleppie	klepje	replacement	12
pusses	puzzelstukjes	explanation	12
gane	gaan	replacement	12
puss	puzzelen	replacement	12
dietuin	dierentuin	explanation	12
tein	trein	noncompletion	3
tein	trein	explanation	24
kimmen	klimmen	explanation	12
ma	mag	explanation	24
klei	kleine	explanation	12
karrebeertjes	koalabeertjes	explanation	12
dit	deze	explanation	12
pisa	pistool	explanation	12
maat	tomaat	explanation	12
we	bewegen	explanation	24
plassijde	bladzijde	explanation	12
konij	konijn	explanation	12
haatjes	haartjes	explanation	12
lape	slapen	explanation	48
laapkamer	slaapkamer	noncompletion	12
moete	moet	replacement	29
sa	anders	replacement	12
sa	van	replacement	6
saat	gaat	explanation	21
kool	goal	explanation	12
kersie	kersje	explanation	12
anne	andere	explanation	24
step	schep	replacement	36
isse	is 'n	explanation	12
isse	is	replacement	12
stepje	schepje	explanation	12
wos	worst	explanation	12
kokool	stoffer	explanation	12
boot	vlag	explanation	12
taat	slaat	explanation	3
taat	staart	explanation	12
taat	staat	replacement	5
taat	gehaald	replacement	6
taat	gaat	replacement	6
rado	radio	explanation	12
poese	poesje	noncompletion	12
kijt	krijt	noncompletion	12
mette	met	replacement	15
gooie	gooien	noncompletion	12
cende	centjes	replacement	12
oppe	in	replacement	12
zotes	grote	explanation	12
burg	berg	explanation	12
saapt	slaapt	explanation	24
inne	de	replacement	12
inne	naar	replacement	12
jafel	tafel	replacement	12
vief	lief	explanation	12
gote	grote	explanation	12
deutje	deurtje	explanation	24
jerke	werk	replacement	12
ite	niet	replacement	12
ansie	vakantie	replacement	12
af	eraf	noncompletion	3
af	is eraf	explanation	12
af	eraf	explanation	12
af	kan eraf	explanation	12
afgewoke	afgebroken	explanation	12
teintje	treintje	noncompletion	12
di's	dit	replacement	12
oote	grote	replacement	12
jantauto	brandweerauto	replacement	12
annetje	mannetje	explanation	12
toot	boot	explanation	24
toot	grote boot	explanation	12
hie	hier	explanation	12
hie	hier	noncompletion	24
soeie	roeien	explanation	12
eze	deze	noncompletion	12
hatel	gaat	replacement	12
el	gaat wel	explanation	12
e'af	moet eraf	explanation	12
chep	schelp	explanation	24
borsel	borstel	noncompletion	12
slarties	Smarties	explanation	12
varkje	varkentje	explanation	12
wor	word	explanation	12
een	de	replacement	3
een	'n	explanation	12
't	wat	explanation	12
hijgen	hijsen	explanation	12
tuperman	Superman	explanation	12
kijna	bijna	explanation	12
klaan	kraan	explanation	12
voorstee	schoorsteen	explanation	12
knorrens	varkens	explanation	12
kein	klein	explanation	12
ooid	gegooid	explanation	12
lullie	jullie	explanation	12
ooien	gooien	explanation	12
luiers	Arjen	replacement	12
Arjen	luiers	replacement	12
tree	twee	explanation	12
n	een	noncompletion	956
evallen	gevallen	noncompletion	12
nog	ook	explanation	12
voor	van	explanation	12
wat	waar	replacement	12
wordt	worden	replacement	3
wordt	hoort	replacement	12
di	dit	noncompletion	39
meeenoomt	meegenoomt	noncompletion	12
kregen	gekregen	noncompletion	24
wegge	weggetje	noncompletion	12
emaakt	gemaakt	noncompletion	18
pelletje	spelletje	noncompletion	12
pot	kapot	noncompletion	48
maakt	deed	replacement	4
maakt	gemaakt	noncompletion	36
tien	Christien	noncompletion	36
kiepen	omkiepen	noncompletion	12
speeld	gespeeld	noncompletion	12
tekker	trekker	explanation	24
nijnties	konijnen	explanation	12
daaro	daarop	noncompletion	12
stapt	gestapt	noncompletion	12
dees	deze	replacement	78
dees	hierin	replacement	3
wintik	winkel	replacement	12
melluk	melk	replacement	12
et	het	noncompletion	60
tie	hij	replacement	33
tie	die	replacement	12
dr	haar	explanation	12
dr	der	noncompletion	10
eers	eerst	noncompletion	23
voorleze	voorlezen	noncompletion	12
knippe	knippen	noncompletion	12
wel…ô	welles	replacement	12
almaal	allemaal	noncompletion	12
ginge	gingen	noncompletion	48
ete	eten	noncompletion	12
macoroni	macaroni	explanation	12
macaronien	macaroni	explanation	12
spele	spelen	noncompletion	12
binne	binnen	noncompletion	12
eve	even	noncompletion	12
gaa	gaan	noncompletion	24
gaa	gaat	noncompletion	12
stoppe	verstoppen	noncompletion	12
vonde	vonden	noncompletion	24
drinke	drinken	noncompletion	12
j	jij	noncompletion	12
vertelle	vertellen	noncompletion	24
losmak	losmaken	noncompletion	12
loshouen	loshouden	noncompletion	12
geworde	geworden	noncompletion	12
reuse	reuzen	replacement	12
em	hem	noncompletion	24
em	hem	replacement	6
tactor	tractor	noncompletion	6
kas	kast	noncompletion	6
dich	dicht	noncompletion	12
diehoek	driehoek	noncompletion	6
choenen	schoenen	noncompletion	6
stawbewie	strawberry	replacement	6
tuife	druiven	replacement	6
boejij	boerderij	replacement	6
ikke	ik	replacement	37
fajeke	varken	replacement	6
schaapje	schaapje	replacement	6
wi	kwil	noncompletion	3
wi	wil	noncompletion	6
ees	eerst	replacement	8
ees	eens	noncompletion	6
tit	dit	replacement	18
tat	dat	replacement	18
tat	want	replacement	6
boe	boer	noncompletion	12
	is	noncompletion	6
taa	daar	replacement	6
ope	open	noncompletion	6
swaa	zwaar	replacement	6
lalle	ladder	replacement	12
gaatie	gaat ie	replacement	6
bea	beer	replacement	6
pajasow	parasol	replacement	6
waket	raket	replacement	6
baw	bal	replacement	6
bofu	boven	replacement	6
teddy	teddybeer	replacement	6
wa	had	replacement	4
wa	wat	noncompletion	12
pele	spelen	noncompletion	12
kinneboejij	kinderboerderij	replacement	6
fogo	vogel	replacement	12
siko	cirkel	replacement	6
bjokje	blokje	replacement	6
kikke	kikker	noncompletion	6
springe	springen	noncompletion	6
daain	daarin	noncompletion	12
toen	doen	replacement	12
asjebies	alsjeblieft	replacement	6
mas	mag	replacement	24
teet	zeep	replacement	6
ies	iets	noncompletion	12
niw	wil	replacement	6
waa	waar	noncompletion	6
tee	zeep	replacement	48
jaatu	water	replacement	6
hiejin	hierin	replacement	6
sjiw	wil	replacement	6
hewu	hebben	replacement	6
houtu	grote	replacement	6
waatu	wagen	replacement	6
pakken	gepakt	replacement	6
jeesoo	lego	replacement	6
kee	keer	noncompletion	8
kee	geen	replacement	6
ein	erin	noncompletion	6
dument	cement	replacement	6
takdoeku	zakdoek	replacement	6
heet	weet	replacement	12
ti	zit	replacement	6
tiej	vier	replacement	6
oo	ook	noncompletion	9
oo	ook	replacement	3
tijken	kijken	replacement	6
hiein	hierin	noncompletion	6
it	ik	replacement	12
nowug	nodig	replacement	6
nowas	nodig	replacement	6
nowus	nodig	replacement	6
too	voor	replacement	6
tij	zij	replacement	6
teep	zeep	replacement	6
z'n	zijn	replacement	20
no	nog	noncompletion	8
draan	deraan	noncompletion	5
kom	komt	noncompletion	11
fiet	fietst	noncompletion	5
chuiven	schuiven	noncompletion	5
ander	anders	noncompletion	5
kaat	gaan	replacement	5
te	ze	replacement	4
te	de	replacement	5
tiern	dieren	replacement	5
nerke	nergens	replacement	5
kij	kijk	noncompletion	5
fftje	eventjes	replacement	5
trarpje	trappetje	replacement	5
parasel	parasol	replacement	5
wee	weet	noncompletion	5
wee	alleen	replacement	5
wortjes	worstjes	replacement	5
wortje	worstje	replacement	5
asjeblief	alsjeblieft	replacement	5
ha	ga	replacement	15
ew	er	replacement	10
naaw	naar	replacement	40
wewk	werk	replacement	5
Jatteliene	Jacqueline	replacement	5
daaw	daar	replacement	10
haat	gaat	replacement	10
jo	zo	replacement	5
weew	weer	replacement	25
dankie	dank je	replacement	5
hewpen	helpen	replacement	5
hiew	hier	replacement	25
maaw	maar	replacement	5
lekkew	lekker	replacement	5
watew	water	replacement	5
annews	anders	replacement	8
waaw	waar	replacement	5
ojifant	olifant	replacement	5
Afwika	Afrika	replacement	5
pas	past	noncompletion	5
oppelost	opgelost	replacement	5
alweew	alweer	replacement	5
naawtoe	naartoe	replacement	5
hebbe	hebben	noncompletion	6
tuurlijk	natuurlijk	noncompletion	6
zitte	zitten	noncompletion	6
deruit	eruit	replacement	6
deeske	deze	replacement	30
ke	de	replacement	42
ke	die	replacement	6
dese	deze	replacement	15
hijs	hij is	replacement	6
eigk	eigenlijk	replacement	6
moek	moet	replacement	12
rijken	rijden	replacement	6
turen	sturen	replacement	6
turen	sturen	noncompletion	6
gwoon	gewoon	noncompletion	12
deke	deze	replacement	6
keraf	eraf	replacement	6
keke	deze	replacement	6
sakhoue	vasthouden	replacement	6
opraaien	opdraaien	noncompletion	6
koch	toch	replacement	6
kat	dat	replacement	6
wak	wat	replacement	6
tuur	stuur	noncompletion	6
kok	ook	replacement	6
pobreren	proberen	replacement	6
ze	zit	explanation	6
ze	hem	replacement	4
ze	zijn	replacement	12
derin	erin	replacement	6
aardbeiijs	aardbeienijs	replacement	6
kijke	kijken	noncompletion	6
deraf	eraf	replacement	6
memen	meenemen	replacement	6
ka	kan	noncompletion	6
opronnu	oprollen	replacement	6
ig	ik	replacement	6
mewk	melk	replacement	6
worst	borst	replacement	6
ennu	en	replacement	6
koeie	koeien	noncompletion	6
bet	bent	noncompletion	6
bent	ben	replacement	6
tinnen	tillen	replacement	6
papot	kapot	replacement	6
uithanen	uithalen	replacement	6
emaak	gemaakt	noncompletion	6
pakot	kapot	replacement	6
si	sit	noncompletion	6
fas	fast	noncompletion	6
wil	wiel	noncompletion	6
wiew	wiel	replacement	6
gron	grond	noncompletion	6
dlupo	duplo	replacement	6
ukeerde	verkeerde	replacement	6
edaa	gedaan	noncompletion	6
tu	toch	replacement	3
tu	dan	replacement	6
wiw	wil	replacement	6
wou	wilde	replacement	8
vashouden	vasthouden	noncompletion	8
tant	want	replacement	8
aws	alles	replacement	16
taar	klaar	replacement	8
neezetten	neerzetten	noncompletion	8
dootassen	doorkrassen	replacement	8
amus	anders	replacement	8
bes	best	noncompletion	8
goot	groot	noncompletion	8
wew	wel	replacement	8
ij	hij	noncompletion	24
dudieping	verdieping	replacement	16
elukkig	gelukkig	noncompletion	8
beut	beurt	noncompletion	8
ra	wat	replacement	8
beurt	gebeurt	replacement	8
ston	stond	noncompletion	8
gewoo	gewoon	noncompletion	8
awes	alles	replacement	8
taag	graag	replacement	8
du	dus	noncompletion	8
waampjes	raampjes	replacement	8
boveop	bovenop	noncompletion	8
kon	konden	replacement	8
niet	geen	replacement	15
naa	naar	noncompletion	16
muneedu	beneden	replacement	8
fietsenpaats	fietsenplaats	noncompletion	8
has	waren	replacement	8
naas	naast	noncompletion	8
leet	weet	replacement	8
va	van	noncompletion	8
ukope	verkoper	replacement	8
fu	van	replacement	8
hat	wat	replacement	8
ting	ging	replacement	8
ukopen	verkopen	replacement	8
awus	alles	replacement	8
opjuuter	computer	replacement	8
hupot	kapot	replacement	8
fingen	gingen	replacement	8
jeddu	verder	replacement	8
tis	wist	replacement	8
tapitein	kapitein	replacement	8
a	als	replacement	8
a	al	noncompletion	8
vawt	valt	replacement	8
hoet	goed	replacement	8
daana	daarna	noncompletion	11
boem	bodem	noncompletion	16
onde	onder	noncompletion	8
fobolt	bijvoorbeeld	replacement	8
aem	adem	noncompletion	12
kie	keer	replacement	8
semmen	zwemmen	replacement	6
semmen	swemmen	noncompletion	16
wemmen	swemmen	noncompletion	8
spellejes	spelletjes	noncompletion	8
stem	zwem	replacement	8
jiejie	jullie	replacement	8
lij	wij	replacement	8
deuit	deruit	noncompletion	8
heer	weer	replacement	8
tiemen	klimmen	replacement	8
amaa	amaal	noncompletion	8
eer	weer	noncompletion	8
keetje	keertje	noncompletion	8
hepen	helpen	noncompletion	8
hopij	voorbij	replacement	8
daahom	waarom	replacement	8
hapjoetu	computer	replacement	8
kame	kamer	noncompletion	8
he	heb	noncompletion	3
he	muts	explanation	6
he	het	noncompletion	8
ondekant	onderkant	noncompletion	8
ebij	erbij	noncompletion	8
Spakeburg	Spakenburg	noncompletion	4
dsjie	keer	replacement	4
baboogam	bubblegum	replacement	8
hun	zij	replacement	4
dag	overdag	replacement	4
verplaatst	veranderd	replacement	4
gedaan	gebouwd	replacement	8
gedaan	gemaakt	replacement	4
heef	heeft	noncompletion	16
heu	heel	replacement	12
veul	veel	replacement	4
bloed	bloeden	replacement	4
zij	zijn	noncompletion	4
bloeten	bloeden	replacement	4
waar	maar	replacement	4
beem	been	replacement	4
haal	haalt	noncompletion	4
deaf	deraf	noncompletion	4
heul	heel	replacement	4
onsnapt	ontsnapt	noncompletion	4
hij	er	replacement	7
glijbaans	glijbanen	replacement	4
morgen	volgende	replacement	4
konijnennoepjes	konijnensnoepjes	replacement	4
konijnennoepje	konijnensnoepje	replacement	8
meng	neem	replacement	4
tom	komt	replacement	3
tom	soms	replacement	4
zeg	zegt	replacement	8
teftef	detective	replacement	8
coachen	coacht	replacement	4
rat	wrat	replacement	3
zembril	zwembril	replacement	3
chool	school	replacement	6
til	stil	replacement	3
tukmaken	stukmaken	replacement	6
silderij	schilderij	replacement	6
ottetreken	optreden	replacement	3
bruikt	gebruikt	replacement	3
taart	staart	replacement	3
pelen	spelen	replacement	12
slijbaan	glijbaan	replacement	3
anre	anderen	replacement	3
tekelen	tekenen	replacement	3
daag	vandaag	replacement	3
filmp	film	replacement	3
woedag	woensdag	replacement	3
keihan	keihard	replacement	3
kont	komt	replacement	3
kleiner	kleinere	noncompletion	3
aan	in	replacement	3
hem	zijn	replacement	3
misschaan	misschien	replacement	3
draai	draait	noncompletion	3
zaag	zagen	replacement	3
viel	valt	replacement	3
omme	omdat	replacement	3
kun	kunnen	replacement	3
alse	als	replacement	3
rekele	rekenen	replacement	3
daarzo	daar	replacement	3
voorbeeld	bijvoorbeeld	replacement	3
wippen	wip	replacement	3
heen	overheen	noncompletion	3
waagtjes	wagentjes	replacement	3
stitten	zitten	replacement	3
loop	lopen	replacement	3
stapel	stapelbed	noncompletion	6
staap	stapelbed	replacement	3
tomme	komt	replacement	3
pasten	pesten	explanation	3
pantoet	pannekoeken	replacement	3
eet	eten	replacement	3
bejo	hallo	explanation	3
teje	gaan	replacement	3
tappe	stap	replacement	3
totedil	krokodil	replacement	3
veven	geven	explanation	6
moven	weg	replacement	12
choot	schoot	explanation	18
poppe	muts	replacement	6
mus	van	replacement	6
mus	muts	explanation	6
anner	andere	explanation	6
ja	op straat	explanation	6
see	sneeuw	explanation	6
vallen	gevallen	explanation	6
tasje	bedje	explanation	6
begbengen	wegbrengen	explanation	12
dzo	zo	explanation	3
bochje	bochtje	explanation	3
anders	andere	explanation	3
saar	daar	explanation	3
saal	haal	explanation	3
saan	gaan	explanation	3
bruiken	gebruiken	explanation	3
keerd	verkeerd	explanation	3
vrastauto	vrachtauto	replacement	3
mooi	mooie	noncompletion	3
siets	fiets	replacement	3
make	maken	noncompletion	21
so	zo	replacement	24
boseop	bovenop	replacement	15
bouwe	bouwen	noncompletion	27
soot	groot	replacement	3
saks	straks	noncompletion	3
nos	nog	replacement	6
boos	bovenop	replacement	3
boo	bovenop	replacement	6
sits	zitten	replacement	3
kga	ikga	noncompletion	3
seppe	scheppen	noncompletion	3
sjep	schep	replacement	3
buite	buiten	noncompletion	3
hare	haren	noncompletion	3
kamme	kammen	noncompletion	6
trees	twee	explanation	3
Jona	jongen	explanation	6
wast	was	explanation	3
hang	hangen	explanation	3
wasde	was	explanation	3
rijs	Parijs	noncompletion	3
waarhee	waarheen	noncompletion	3
dez	deze	noncompletion	3
