gebakt	gebakken	Overgeneralisation
ebakt	gebakken	Overgeneralisation
bakt	gebakken	Overgeneralisation
sebakt	gebakken	Overgeneralisation+prefix ge pronounced as se
gebakte	gebakkene	Overgeneralisation+
ebakte	gebakkene	Overgeneralisation+Prefix ge without onset
sebakte	gebakkene	Overgeneralisation+prefix ge pronounced as se
ebakken	gebakken	Prefix ge without onset
bakken	gebakken	Lacking ge prefix
geband	gebannen	Overgeneralisation
eband	gebannen	Overgeneralisation+Prefix ge without onset
band	gebannen	Overgeneralisation+Lacking ge prefix
seband	gebannen	Overgeneralisation+prefix ge pronounced as se
gebande	gebannene	Overgeneralisation+
ebande	gebannene	Overgeneralisation+Prefix ge without onset
sebande	gebannene	Overgeneralisation+prefix ge pronounced as se
gebant	gebannen	Overgeneralisation
ebant	gebannen	Overgeneralisation
bant	gebannen	Overgeneralisation
ebannen	gebannen	Prefix ge without onset
bannen	gebannen	Lacking ge prefix
gebarst	gebarsten	Overgeneralisation
ebarst	gebarsten	Overgeneralisation
barst	gebarsten	Overgeneralisation
sebarst	gebarsten	Overgeneralisation+prefix ge pronounced as se
gebarste	gebarstene	Overgeneralisation+
ebarste	gebarstene	Overgeneralisation+Prefix ge without onset
sebarste	gebarstene	Overgeneralisation+prefix ge pronounced as se
ebarsten	gebarsten	Prefix ge without onset
barsten	gebarsten	Lacking ge prefix
bederfde	bedorvene	Overgeneralisation
bederfden	bedierven	Overgeneralisation
bedierfde	bedierf	Irregular form plus regular suffix
bedierfden	bedierven	Irregular form plus regular suffix
bederfd	bedorven	Overgeneralisation
bederft	bedorven	Overgeneralisation
bederfen	bedorven	Wrong -en suffix
bedorfd	bedorven	Overgeneralisation
bedorft	bedorven	Overgeneralisation
bedriegde	bedrogene	Overgeneralisation
bedriegden	bedrogen	Overgeneralisation
bedroogde	bedroog	Irregular form plus regular suffix
bedroogden	bedrogen	Irregular form plus regular suffix
bedriegd	bedrogen	Overgeneralisation
bedriegt	bedrogen	Overgeneralisation
bedriegen	bedrogen	Wrong -en suffix
bedroogt	bedrogen	Overgeneralisation
beginde	begonnene	Overgeneralisation
beginden	begonnen	Overgeneralisation
begonde	begon	Irregular form plus regular suffix
begonden	begonnen	Irregular form plus regular suffix
begind	begonnen	Overgeneralisation
begint	begonnen	Overgeneralisation
beginnen	begonnen	Wrong -en suffix
begont	begonnen	Overgeneralisation
behangde	behangene	Overgeneralisation
behangden	behingen	Overgeneralisation
behingde	behing	Irregular form plus regular suffix
behingden	behingen	Irregular form plus regular suffix
behangd	behangen	Overgeneralisation
behangt	behangen	Overgeneralisation
bergde	borg	Overgeneralisation
bergden	borgen	Overgeneralisation
borgde	borg	Irregular form plus regular suffix
borgden	borgen	Irregular form plus regular suffix
gebergd	geborgen	Overgeneralisation+
ebergd	geborgen	Overgeneralisation+Prefix ge without onset
bergd	geborgen	Overgeneralisation+Lacking ge prefix
sebergd	geborgen	Overgeneralisation+prefix ge pronounced as se
gebergde	geborgene	Overgeneralisation+
ebergde	geborgene	Overgeneralisation+Prefix ge without onset
sebergde	geborgene	Overgeneralisation+prefix ge pronounced as se
gebergt	geborgen	Overgeneralisation
ebergt	geborgen	Overgeneralisation
bergt	geborgen	Overgeneralisation
gebergen	geborgen	Wrong -en suffix
ebergen	geborgen	Wrong -en suffix
bergen	geborgen	Wrong -en suffix
geborgd	geborgen	Overgeneralisation
geborgt	geborgen	Overgeneralisation
eborgen	geborgen	Prefix ge without onset
borgen	geborgen	Lacking ge prefix
beveelde	bevolene	Overgeneralisation
beveelden	bevalen	Overgeneralisation
bevalde	beval	Irregular form plus regular suffix
bevalden	bevalen	Irregular form plus regular suffix
beveeld	bevolen	Overgeneralisation
beveelt	bevolen	Overgeneralisation
bevelen	bevolen	Wrong -en suffix
bevoolt	bevolen	Overgeneralisation
bezwijkte	bezwekene	Overgeneralisation
bezwijkten	bezweken	Overgeneralisation
bezweekte	bezweek	Irregular form plus regular suffix
bezweekten	bezweken	Irregular form plus regular suffix
bezwijkt	bezweken	Overgeneralisation
bezwijken	bezweken	Wrong -en suffix
bezweekt	bezweken	Overgeneralisation
bidde	bad	Overgeneralisation
bidden	gebeden	Wrong -en suffix
badde	bad	Irregular form plus regular suffix
badden	baden	Irregular form plus regular suffix
gebid	gebeden	Overgeneralisation
ebid	gebeden	Overgeneralisation
bid	gebeden	Overgeneralisation
sebid	gebeden	Overgeneralisation+prefix ge pronounced as se
gebidde	gebedene	Overgeneralisation+
ebidde	gebedene	Overgeneralisation+Prefix ge without onset
sebidde	gebedene	Overgeneralisation+prefix ge pronounced as se
gebidden	gebeden	Wrong -en suffix
ebidden	gebeden	Wrong -en suffix
gebeed	gebeden	Overgeneralisation
ebeden	gebeden	Prefix ge without onset
beden	gebeden	Lacking ge prefix
biedde	bood	Overgeneralisation
biedden	boden	Overgeneralisation
boodde	bood	Irregular form plus regular suffix
boodden	boden	Irregular form plus regular suffix
gebied	geboden	Overgeneralisation
ebied	geboden	Overgeneralisation
bied	geboden	Overgeneralisation
sebied	geboden	Overgeneralisation+prefix ge pronounced as se
gebiede	gebodene	Overgeneralisation+
ebiede	gebodene	Overgeneralisation+Prefix ge without onset
sebiede	gebodene	Overgeneralisation+prefix ge pronounced as se
gebieden	geboden	Wrong -en suffix
ebieden	geboden	Wrong -en suffix
bieden	geboden	Wrong -en suffix
geboodt	geboden	Overgeneralisation
gebood	geboden	Overgeneralisation
eboden	geboden	Prefix ge without onset
boden	geboden	Lacking ge prefix
bijtte	beet	Overgeneralisation
bijtten	beten	Overgeneralisation
beette	beet	Irregular form plus regular suffix
beetten	beten	Irregular form plus regular suffix
gebijt	gebeten	Overgeneralisation
ebijt	gebeten	Overgeneralisation
bijt	gebeten	Overgeneralisation
sebijt	gebeten	Overgeneralisation+prefix ge pronounced as se
gebijte	gebetene	Overgeneralisation+
ebijte	gebetene	Overgeneralisation+Prefix ge without onset
sebijte	gebetene	Overgeneralisation+prefix ge pronounced as se
gebijten	gebeten	Wrong -en suffix
ebijten	gebeten	Wrong -en suffix
bijten	gebeten	Wrong -en suffix
gebeet	gebeten	Overgeneralisation
ebeten	gebeten	Prefix ge without onset
beten	gebeten	Lacking ge prefix
bindde	bond	Overgeneralisation
bindden	bonden	Overgeneralisation
bondde	bond	Irregular form plus regular suffix
bondden	bonden	Irregular form plus regular suffix
gebind	gebonden	Overgeneralisation
ebind	gebonden	Overgeneralisation
bind	gebonden	Overgeneralisation
sebind	gebonden	Overgeneralisation+prefix ge pronounced as se
gebinde	gebondene	Overgeneralisation+
ebinde	gebondene	Overgeneralisation+Prefix ge without onset
sebinde	gebondene	Overgeneralisation+prefix ge pronounced as se
gebinden	gebonden	Wrong -en suffix
ebinden	gebonden	Wrong -en suffix
binden	gebonden	Wrong -en suffix
gebond	gebonden	Overgeneralisation
ebonden	gebonden	Prefix ge without onset
bonden	gebonden	Lacking ge prefix
blaasde	blies	Overgeneralisation
blaasden	bliezen	Overgeneralisation
bliesde	blies	Irregular form plus regular suffix
bliesden	bliezen	Irregular form plus regular suffix
geblaasd	geblazen	Overgeneralisation
eblaasd	geblazen	Overgeneralisation+Prefix ge without onset
blaasd	geblazen	Overgeneralisation+Lacking ge prefix
seblaasd	geblazen	Overgeneralisation+prefix ge pronounced as se
geblaasde	geblazene	Overgeneralisation+
eblaasde	geblazene	Overgeneralisation+Prefix ge without onset
seblaasde	geblazene	Overgeneralisation+prefix ge pronounced as se
geblaast	geblazen	Overgeneralisation
eblaast	geblazen	Overgeneralisation
blaast	geblazen	Overgeneralisation
geblasen	geblazen	Wrong -en suffix
eblasen	geblazen	Wrong -en suffix
blasen	geblazen	Wrong -en suffix
eblazen	geblazen	Prefix ge without onset
blazen	geblazen	Lacking ge prefix
blijkte	bleek	Overgeneralisation
blijkten	bleken	Overgeneralisation
bleekte	bleek	Irregular form plus regular suffix
bleekten	bleken	Irregular form plus regular suffix
geblijkt	gebleken	Overgeneralisation
eblijkt	gebleken	Overgeneralisation
blijkt	gebleken	Overgeneralisation
seblijkt	gebleken	Overgeneralisation+prefix ge pronounced as se
geblijkte	geblekene	Overgeneralisation+
eblijkte	geblekene	Overgeneralisation+Prefix ge without onset
seblijkte	geblekene	Overgeneralisation+prefix ge pronounced as se
geblijken	gebleken	Wrong -en suffix
eblijken	gebleken	Wrong -en suffix
blijken	gebleken	Wrong -en suffix
gebleekt	gebleken	Overgeneralisation
ebleken	gebleken	Prefix ge without onset
bleken	gebleken	Lacking ge prefix
blijfde	bleef	Overgeneralisation
blijfden	bleven	Overgeneralisation
bleefde	bleef	Irregular form plus regular suffix
bleefden	bleven	Irregular form plus regular suffix
geblijfd	gebleven	Overgeneralisation+
eblijfd	gebleven	Overgeneralisation+Prefix ge without onset
blijfd	gebleven	Overgeneralisation+Lacking ge prefix
seblijfd	gebleven	Overgeneralisation+prefix ge pronounced as se
geblijfde	geblevene	Overgeneralisation+
eblijfde	geblevene	Overgeneralisation+Prefix ge without onset
seblijfde	geblevene	Overgeneralisation+prefix ge pronounced as se
geblijft	gebleven	Overgeneralisation
eblijft	gebleven	Overgeneralisation
blijft	gebleven	Overgeneralisation
geblijfen	gebleven	Wrong -en suffix
eblijfen	gebleven	Wrong -en suffix
blijfen	gebleven	Wrong -en suffix
gebleefd	gebleven	Overgeneralisation
gebleeft	gebleven	Overgeneralisation
ebleven	gebleven	Prefix ge without onset
bleven	gebleven	Lacking ge prefix
blinkte	blonk	Overgeneralisation
blinkten	blonken	Overgeneralisation
blonkte	blonk	Irregular form plus regular suffix
blonkten	blonken	Irregular form plus regular suffix
geblinkt	geblonken	Overgeneralisation
eblinkt	geblonken	Overgeneralisation
blinkt	geblonken	Overgeneralisation
seblinkt	geblonken	Overgeneralisation+prefix ge pronounced as se
geblinkte	geblonkene	Overgeneralisation+
eblinkte	geblonkene	Overgeneralisation+Prefix ge without onset
seblinkte	geblonkene	Overgeneralisation+prefix ge pronounced as se
geblinken	geblonken	Wrong -en suffix
eblinken	geblonken	Wrong -en suffix
blinken	geblonken	Wrong -en suffix
geblonkt	geblonken	Overgeneralisation
eblonken	geblonken	Prefix ge without onset
blonken	geblonken	Lacking ge prefix
gebraad	gebraden	Overgeneralisation
ebraad	gebraden	Overgeneralisation
braad	gebraden	Overgeneralisation
sebraad	gebraden	Overgeneralisation+prefix ge pronounced as se
gebrade	gebradene	Overgeneralisation+
ebrade	gebradene	Overgeneralisation+Prefix ge without onset
sebrade	gebradene	Overgeneralisation+prefix ge pronounced as se
ebraden	gebraden	Prefix ge without onset
braden	gebraden	Lacking ge prefix
breekte	brak	Overgeneralisation
breekten	braken	Overgeneralisation
brakte	brak	Irregular form plus regular suffix
brakten	braken	Irregular form plus regular suffix
gebreekt	gebroken	Overgeneralisation
ebreekt	gebroken	Overgeneralisation
breekt	gebroken	Overgeneralisation
sebreekt	gebroken	Overgeneralisation+prefix ge pronounced as se
gebreekte	gebrokene	Overgeneralisation+
ebreekte	gebrokene	Overgeneralisation+Prefix ge without onset
sebreekte	gebrokene	Overgeneralisation+prefix ge pronounced as se
gebreken	gebroken	Wrong -en suffix
ebreken	gebroken	Wrong -en suffix
breken	gebroken	Wrong -en suffix
gebrookt	gebroken	Overgeneralisation
ebroken	gebroken	Prefix ge without onset
broken	gebroken	Lacking ge prefix
brengde	bracht	Overgeneralisation
brengden	brachten	Overgeneralisation
brachtde	bracht	Irregular form plus regular suffix
brachtden	brachten	Irregular form plus regular suffix
gebrengd	gebracht	Overgeneralisation+
ebrengd	gebracht	Overgeneralisation+Prefix ge without onset
brengd	gebracht	Overgeneralisation+Lacking ge prefix
sebrengd	gebracht	Overgeneralisation+prefix ge pronounced as se
gebrengde	gebrachte	Overgeneralisation+
ebrengde	gebrachte	Overgeneralisation+Prefix ge without onset
sebrengde	gebrachte	Overgeneralisation+prefix ge pronounced as se
gebrengt	gebracht	Overgeneralisation
ebrengt	gebracht	Overgeneralisation
brengt	gebracht	Overgeneralisation
gebrengen	gebracht	Wrong -en suffix
ebrengen	gebracht	Wrong -en suffix
brengen	gebracht	Wrong -en suffix
ebracht	gebracht	Prefix ge without onset
bracht	gebracht	Lacking ge prefix
gebrouwd	gebrouwen	Overgeneralisation
ebrouwd	gebrouwen	Overgeneralisation+Prefix ge without onset
brouwd	gebrouwen	Overgeneralisation+Lacking ge prefix
sebrouwd	gebrouwen	Overgeneralisation+prefix ge pronounced as se
gebrouwde	gebrouwene	Overgeneralisation+
ebrouwde	gebrouwene	Overgeneralisation+Prefix ge without onset
sebrouwde	gebrouwene	Overgeneralisation+prefix ge pronounced as se
gebrouwt	gebrouwen	Overgeneralisation
ebrouwt	gebrouwen	Overgeneralisation
brouwt	gebrouwen	Overgeneralisation
ebrouwen	gebrouwen	Prefix ge without onset
brouwen	gebrouwen	Lacking ge prefix
buigde	boog	Overgeneralisation
buigden	bogen	Overgeneralisation
boogde	boog	Irregular form plus regular suffix
boogden	bogen	Irregular form plus regular suffix
gebuigd	gebogen	Overgeneralisation+
ebuigd	gebogen	Overgeneralisation+Prefix ge without onset
buigd	gebogen	Overgeneralisation+Lacking ge prefix
sebuigd	gebogen	Overgeneralisation+prefix ge pronounced as se
gebuigde	gebogene	Overgeneralisation+
ebuigde	gebogene	Overgeneralisation+Prefix ge without onset
sebuigde	gebogene	Overgeneralisation+prefix ge pronounced as se
gebuigt	gebogen	Overgeneralisation
ebuigt	gebogen	Overgeneralisation
buigt	gebogen	Overgeneralisation
gebuigen	gebogen	Wrong -en suffix
ebuigen	gebogen	Wrong -en suffix
buigen	gebogen	Wrong -en suffix
geboogt	gebogen	Overgeneralisation
ebogen	gebogen	Prefix ge without onset
bogen	gebogen	Lacking ge prefix
denkte	dacht	Overgeneralisation
denkten	dachten	Overgeneralisation
dachtte	dacht	Irregular form plus regular suffix
dachtten	dachten	Irregular form plus regular suffix
gedenkt	gedacht	Overgeneralisation
edenkt	gedacht	Overgeneralisation
denkt	gedacht	Overgeneralisation
sedenkt	gedacht	Overgeneralisation+prefix ge pronounced as se
gedenkte	gedachte	Overgeneralisation+
edenkte	gedachte	Overgeneralisation+Prefix ge without onset
sedenkte	gedachte	Overgeneralisation+prefix ge pronounced as se
gedenken	gedacht	Wrong -en suffix
edenken	gedacht	Wrong -en suffix
denken	gedacht	Wrong -en suffix
edacht	gedacht	Prefix ge without onset
dacht	gedacht	Lacking ge prefix
dingde	dong	Overgeneralisation
dingden	dongen	Overgeneralisation
dongde	dong	Irregular form plus regular suffix
dongden	dongen	Irregular form plus regular suffix
gedingd	gedongen	Overgeneralisation+
edingd	gedongen	Overgeneralisation+Prefix ge without onset
dingd	gedongen	Overgeneralisation+Lacking ge prefix
sedingd	gedongen	Overgeneralisation+prefix ge pronounced as se
gedingde	gedongene	Overgeneralisation+
edingde	gedongene	Overgeneralisation+Prefix ge without onset
sedingde	gedongene	Overgeneralisation+prefix ge pronounced as se
gedingt	gedongen	Overgeneralisation
edingt	gedongen	Overgeneralisation
dingt	gedongen	Overgeneralisation
gedingen	gedongen	Wrong -en suffix
edingen	gedongen	Wrong -en suffix
dingen	gedongen	Wrong -en suffix
gedongd	gedongen	Overgeneralisation
gedongt	gedongen	Overgeneralisation
edongen	gedongen	Prefix ge without onset
dongen	gedongen	Lacking ge prefix
doete	deed	Overgeneralisation
doeten	deden	Overgeneralisation
deedte	deed	Irregular form plus regular suffix
deedten	deden	Irregular form plus regular suffix
gedoet	gedaan	Overgeneralisation
edoet	gedaan	Overgeneralisation
doet	gedaan	Overgeneralisation
sedoet	gedaan	Overgeneralisation+prefix ge pronounced as se
gedoete	gedaane	Overgeneralisation+
edoete	gedaane	Overgeneralisation+Prefix ge without onset
sedoete	gedaane	Overgeneralisation+prefix ge pronounced as se
gedoen	gedaan	Wrong -en suffix
edoen	gedaan	Wrong -en suffix
doen	gedaan	Wrong -en suffix
edaan	gedaan	Prefix ge without onset
daan	gedaan	Lacking ge prefix
draagde	droeg	Overgeneralisation
draagden	droegen	Overgeneralisation
droegde	droeg	Irregular form plus regular suffix
droegden	droegen	Irregular form plus regular suffix
gedraagd	gedragen	Overgeneralisation
edraagd	gedragen	Overgeneralisation+Prefix ge without onset
draagd	gedragen	Overgeneralisation+Lacking ge prefix
sedraagd	gedragen	Overgeneralisation+prefix ge pronounced as se
gedraagde	gedragene	Overgeneralisation+
edraagde	gedragene	Overgeneralisation+Prefix ge without onset
sedraagde	gedragene	Overgeneralisation+prefix ge pronounced as se
gedraagt	gedragen	Overgeneralisation
edraagt	gedragen	Overgeneralisation
draagt	gedragen	Overgeneralisation
edragen	gedragen	Prefix ge without onset
dragen	gedragen	Lacking ge prefix
drijfde	dreef	Overgeneralisation
drijfden	dreven	Overgeneralisation
dreefde	dreef	Irregular form plus regular suffix
dreefden	dreven	Irregular form plus regular suffix
gedrijfd	gedreven	Overgeneralisation+
edrijfd	gedreven	Overgeneralisation+Prefix ge without onset
drijfd	gedreven	Overgeneralisation+Lacking ge prefix
sedrijfd	gedreven	Overgeneralisation+prefix ge pronounced as se
gedrijfde	gedrevene	Overgeneralisation+
edrijfde	gedrevene	Overgeneralisation+Prefix ge without onset
sedrijfde	gedrevene	Overgeneralisation+prefix ge pronounced as se
gedrijft	gedreven	Overgeneralisation
edrijft	gedreven	Overgeneralisation
drijft	gedreven	Overgeneralisation
gedrijfen	gedreven	Wrong -en suffix
edrijfen	gedreven	Wrong -en suffix
drijfen	gedreven	Wrong -en suffix
gedreefd	gedreven	Overgeneralisation
gedreeft	gedreven	Overgeneralisation
edreven	gedreven	Prefix ge without onset
dreven	gedreven	Lacking ge prefix
dringde	drong	Overgeneralisation
dringden	drongen	Overgeneralisation
drongde	drong	Irregular form plus regular suffix
drongden	drongen	Irregular form plus regular suffix
gedringd	gedrongen	Overgeneralisation+
edringd	gedrongen	Overgeneralisation+Prefix ge without onset
dringd	gedrongen	Overgeneralisation+Lacking ge prefix
sedringd	gedrongen	Overgeneralisation+prefix ge pronounced as se
gedringde	gedrongene	Overgeneralisation+
edringde	gedrongene	Overgeneralisation+Prefix ge without onset
sedringde	gedrongene	Overgeneralisation+prefix ge pronounced as se
gedringt	gedrongen	Overgeneralisation
edringt	gedrongen	Overgeneralisation
dringt	gedrongen	Overgeneralisation
gedringen	gedrongen	Wrong -en suffix
edringen	gedrongen	Wrong -en suffix
dringen	gedrongen	Wrong -en suffix
gedrongd	gedrongen	Overgeneralisation
gedrongt	gedrongen	Overgeneralisation
edrongen	gedrongen	Prefix ge without onset
drongen	gedrongen	Lacking ge prefix
drinkte	dronk	Overgeneralisation
drinkten	dronken	Overgeneralisation
dronkte	dronk	Irregular form plus regular suffix
dronkten	dronken	Irregular form plus regular suffix
gedrinkt	gedronken	Overgeneralisation
edrinkt	gedronken	Overgeneralisation
drinkt	gedronken	Overgeneralisation
sedrinkt	gedronken	Overgeneralisation+prefix ge pronounced as se
gedrinkte	gedronkene	Overgeneralisation+
edrinkte	gedronkene	Overgeneralisation+Prefix ge without onset
sedrinkte	gedronkene	Overgeneralisation+prefix ge pronounced as se
gedrinken	gedronken	Wrong -en suffix
edrinken	gedronken	Wrong -en suffix
drinken	gedronken	Wrong -en suffix
gedronkt	gedronken	Overgeneralisation
edronken	gedronken	Prefix ge without onset
dronken	gedronken	Lacking ge prefix
druipte	droop	Overgeneralisation
druipten	dropen	Overgeneralisation
droopte	droop	Irregular form plus regular suffix
droopten	dropen	Irregular form plus regular suffix
gedruipt	gedropen	Overgeneralisation
edruipt	gedropen	Overgeneralisation
druipt	gedropen	Overgeneralisation
sedruipt	gedropen	Overgeneralisation+prefix ge pronounced as se
gedruipte	gedropene	Overgeneralisation+
edruipte	gedropene	Overgeneralisation+Prefix ge without onset
sedruipte	gedropene	Overgeneralisation+prefix ge pronounced as se
gedruipen	gedropen	Wrong -en suffix
edruipen	gedropen	Wrong -en suffix
druipen	gedropen	Wrong -en suffix
gedroopt	gedropen	Overgeneralisation
edropen	gedropen	Prefix ge without onset
dropen	gedropen	Lacking ge prefix
duikte	dook	Overgeneralisation
duikten	doken	Overgeneralisation
dookte	dook	Irregular form plus regular suffix
dookten	doken	Irregular form plus regular suffix
geduikt	gedoken	Overgeneralisation
eduikt	gedoken	Overgeneralisation
duikt	gedoken	Overgeneralisation
seduikt	gedoken	Overgeneralisation+prefix ge pronounced as se
geduikte	gedokene	Overgeneralisation+
eduikte	gedokene	Overgeneralisation+Prefix ge without onset
seduikte	gedokene	Overgeneralisation+prefix ge pronounced as se
geduiken	gedoken	Wrong -en suffix
eduiken	gedoken	Wrong -en suffix
duiken	gedoken	Wrong -en suffix
gedookt	gedoken	Overgeneralisation
edoken	gedoken	Prefix ge without onset
doken	gedoken	Lacking ge prefix
dwingde	dwong	Overgeneralisation
dwingden	dwongen	Overgeneralisation
dwongde	dwong	Irregular form plus regular suffix
dwongden	dwongen	Irregular form plus regular suffix
gedwingd	gedwongen	Overgeneralisation+
edwingd	gedwongen	Overgeneralisation+Prefix ge without onset
dwingd	gedwongen	Overgeneralisation+Lacking ge prefix
sedwingd	gedwongen	Overgeneralisation+prefix ge pronounced as se
gedwingde	gedwongene	Overgeneralisation+
edwingde	gedwongene	Overgeneralisation+Prefix ge without onset
sedwingde	gedwongene	Overgeneralisation+prefix ge pronounced as se
gedwingt	gedwongen	Overgeneralisation
edwingt	gedwongen	Overgeneralisation
dwingt	gedwongen	Overgeneralisation
gedwingen	gedwongen	Wrong -en suffix
edwingen	gedwongen	Wrong -en suffix
dwingen	gedwongen	Wrong -en suffix
gedwongd	gedwongen	Overgeneralisation
gedwongt	gedwongen	Overgeneralisation
edwongen	gedwongen	Prefix ge without onset
dwongen	gedwongen	Lacking ge prefix
eette	at	Overgeneralisation
eetten	aten	Overgeneralisation
atte	at	Irregular form plus regular suffix
atten	aten	Irregular form plus regular suffix
geeet	gegeten	Overgeneralisation+
eeet	gegeten	Overgeneralisation+Prefix ge without onset
eet	gegeten	Overgeneralisation
seeet	gegeten	Overgeneralisation+prefix ge pronounced as se
geete	gegetene	Overgeneralisation+
eete	gegetene	Overgeneralisation+Prefix ge without onset
seete	gegetene	Overgeneralisation+prefix ge pronounced as se
geëet	gegeten	Overgeneralisation
eëet	gegeten	Overgeneralisation
geëten	gegeten	Wrong -en suffix
eëten	gegeten	Wrong -en suffix
eten	gegeten	Wrong -en suffix
gegeet	gegeten	Overgeneralisation
egeten	gegeten	Prefix ge without onset
geten	gegeten	Lacking ge prefix
fluitte	floot	Overgeneralisation
fluitten	floten	Overgeneralisation
flootte	floot	Irregular form plus regular suffix
flootten	floten	Irregular form plus regular suffix
gefluit	gefloten	Overgeneralisation
efluit	gefloten	Overgeneralisation
fluit	gefloten	Overgeneralisation
sefluit	gefloten	Overgeneralisation+prefix ge pronounced as se
gefluite	geflotene	Overgeneralisation+
efluite	geflotene	Overgeneralisation+Prefix ge without onset
sefluite	geflotene	Overgeneralisation+prefix ge pronounced as se
gefluiten	gefloten	Wrong -en suffix
efluiten	gefloten	Wrong -en suffix
fluiten	gefloten	Wrong -en suffix
gefloot	gefloten	Overgeneralisation
efloten	gefloten	Prefix ge without onset
floten	gefloten	Lacking ge prefix
gade	ging	Overgeneralisation
gaden	gingen	Overgeneralisation
gingde	ging	Irregular form plus regular suffix
gingden	gingen	Irregular form plus regular suffix
gegaad	gegaan	Overgeneralisation+
egaad	gegaan	Overgeneralisation+Prefix ge without onset
gaad	gegaan	Overgeneralisation+Lacking ge prefix
segaad	gegaan	Overgeneralisation+prefix ge pronounced as se
gegade	gegaane	Overgeneralisation+
egade	gegaane	Overgeneralisation+Prefix ge without onset
segade	gegaane	Overgeneralisation+prefix ge pronounced as se
gegaat	gegaan	Overgeneralisation
egaat	gegaan	Overgeneralisation
gaat	gegaan	Overgeneralisation
egaan	gegaan	Prefix ge without onset
gaan	gegaan	Lacking ge prefix
geldde	gold	Overgeneralisation
geldden	golden	Overgeneralisation
goldde	gold	Irregular form plus regular suffix
goldden	golden	Irregular form plus regular suffix
gegeld	gegolden	Overgeneralisation
egeld	gegolden	Overgeneralisation
geld	gegolden	Overgeneralisation
segeld	gegolden	Overgeneralisation+prefix ge pronounced as se
gegelde	gegoldene	Overgeneralisation+
egelde	gegoldene	Overgeneralisation+Prefix ge without onset
segelde	gegoldene	Overgeneralisation+prefix ge pronounced as se
gegelden	gegolden	Wrong -en suffix
egelden	gegolden	Wrong -en suffix
gelden	gegolden	Wrong -en suffix
gegold	gegolden	Overgeneralisation
egolden	gegolden	Prefix ge without onset
golden	gegolden	Lacking ge prefix
geneesde	genezene	Overgeneralisation
geneesden	genazen	Overgeneralisation
genasde	genas	Irregular form plus regular suffix
genasden	genazen	Irregular form plus regular suffix
geneesd	genezen	Overgeneralisation
geneest	genezen	Overgeneralisation
genesen	genezen	Wrong -en suffix
enezen	genezen	Prefix ge without onset
nezen	genezen	Lacking ge prefix
geniette	genoot	Overgeneralisation
genietten	genoten	Overgeneralisation
genootte	genoot	Irregular form plus regular suffix
genootten	genoten	Irregular form plus regular suffix
geniet	genoten	Overgeneralisation
geniete	genotene	Overgeneralisation
genieten	genoten	Wrong -en suffix
genoot	genoten	Overgeneralisation
enoten	genoten	Prefix ge without onset
noten	genoten	Lacking ge prefix
geefde	gaf	Overgeneralisation
geefden	gaven	Overgeneralisation
gafde	gaf	Irregular form plus regular suffix
gafden	gaven	Irregular form plus regular suffix
gegeefd	gegeven	Overgeneralisation
egeefd	gegeven	Overgeneralisation+Prefix ge without onset
geefd	gegeven	Overgeneralisation+Lacking ge prefix
segeefd	gegeven	Overgeneralisation+prefix ge pronounced as se
gegeefde	gegevene	Overgeneralisation+
egeefde	gegevene	Overgeneralisation+Prefix ge without onset
segeefde	gegevene	Overgeneralisation+prefix ge pronounced as se
gegeeft	gegeven	Overgeneralisation
egeeft	gegeven	Overgeneralisation
geeft	gegeven	Overgeneralisation
gegefen	gegeven	Wrong -en suffix
egefen	gegeven	Wrong -en suffix
gefen	gegeven	Wrong -en suffix
egeven	gegeven	Prefix ge without onset
geven	gegeven	Lacking ge prefix
giette	goot	Overgeneralisation
gietten	goten	Overgeneralisation
gootte	goot	Irregular form plus regular suffix
gootten	goten	Irregular form plus regular suffix
gegiet	gegoten	Overgeneralisation
egiet	gegoten	Overgeneralisation
giet	gegoten	Overgeneralisation
segiet	gegoten	Overgeneralisation+prefix ge pronounced as se
gegiete	gegotene	Overgeneralisation+
egiete	gegotene	Overgeneralisation+Prefix ge without onset
segiete	gegotene	Overgeneralisation+prefix ge pronounced as se
gegieten	gegoten	Wrong -en suffix
egieten	gegoten	Wrong -en suffix
gieten	gegoten	Wrong -en suffix
gegoot	gegoten	Overgeneralisation
egoten	gegoten	Prefix ge without onset
goten	gegoten	Lacking ge prefix
glijdde	gleed	Overgeneralisation
glijdden	gleden	Overgeneralisation
gleedde	gleed	Irregular form plus regular suffix
gleedden	gleden	Irregular form plus regular suffix
geglijd	gegleden	Overgeneralisation
eglijd	gegleden	Overgeneralisation
glijd	gegleden	Overgeneralisation
seglijd	gegleden	Overgeneralisation+prefix ge pronounced as se
geglijde	gegledene	Overgeneralisation+
eglijde	gegledene	Overgeneralisation+Prefix ge without onset
seglijde	gegledene	Overgeneralisation+prefix ge pronounced as se
geglijden	gegleden	Wrong -en suffix
eglijden	gegleden	Wrong -en suffix
glijden	gegleden	Wrong -en suffix
gegleed	gegleden	Overgeneralisation
egleden	gegleden	Prefix ge without onset
gleden	gegleden	Lacking ge prefix
glimde	glom	Overgeneralisation
glimden	glommen	Overgeneralisation
glomde	glom	Irregular form plus regular suffix
glomden	glommen	Irregular form plus regular suffix
geglimd	geglommen	Overgeneralisation+
eglimd	geglommen	Overgeneralisation+Prefix ge without onset
glimd	geglommen	Overgeneralisation+Lacking ge prefix
seglimd	geglommen	Overgeneralisation+prefix ge pronounced as se
geglimde	geglommene	Overgeneralisation+
eglimde	geglommene	Overgeneralisation+Prefix ge without onset
seglimde	geglommene	Overgeneralisation+prefix ge pronounced as se
geglimt	geglommen	Overgeneralisation
eglimt	geglommen	Overgeneralisation
glimt	geglommen	Overgeneralisation
geglimmen	geglommen	Wrong -en suffix
eglimmen	geglommen	Wrong -en suffix
glimmen	geglommen	Wrong -en suffix
geglomt	geglommen	Overgeneralisation
eglommen	geglommen	Prefix ge without onset
glommen	geglommen	Lacking ge prefix
graafde	groef	Overgeneralisation
graafden	groeven	Overgeneralisation
groefde	groef	Irregular form plus regular suffix
groefden	groeven	Irregular form plus regular suffix
gegraafd	gegraven	Overgeneralisation
egraafd	gegraven	Overgeneralisation+Prefix ge without onset
graafd	gegraven	Overgeneralisation+Lacking ge prefix
segraafd	gegraven	Overgeneralisation+prefix ge pronounced as se
gegraafde	gegravene	Overgeneralisation+
egraafde	gegravene	Overgeneralisation+Prefix ge without onset
segraafde	gegravene	Overgeneralisation+prefix ge pronounced as se
gegraaft	gegraven	Overgeneralisation
egraaft	gegraven	Overgeneralisation
graaft	gegraven	Overgeneralisation
gegrafen	gegraven	Wrong -en suffix
egrafen	gegraven	Wrong -en suffix
grafen	gegraven	Wrong -en suffix
egraven	gegraven	Prefix ge without onset
graven	gegraven	Lacking ge prefix
grijpte	greep	Overgeneralisation
grijpten	grepen	Overgeneralisation
greepte	greep	Irregular form plus regular suffix
greepten	grepen	Irregular form plus regular suffix
gegrijpt	gegrepen	Overgeneralisation
egrijpt	gegrepen	Overgeneralisation
grijpt	gegrepen	Overgeneralisation
segrijpt	gegrepen	Overgeneralisation+prefix ge pronounced as se
gegrijpte	gegrepene	Overgeneralisation+
egrijpte	gegrepene	Overgeneralisation+Prefix ge without onset
segrijpte	gegrepene	Overgeneralisation+prefix ge pronounced as se
gegrijpen	gegrepen	Wrong -en suffix
egrijpen	gegrepen	Wrong -en suffix
grijpen	gegrepen	Wrong -en suffix
gegreept	gegrepen	Overgeneralisation
egrepen	gegrepen	Prefix ge without onset
grepen	gegrepen	Lacking ge prefix
hangde	hing	Overgeneralisation
hangden	hingen	Overgeneralisation
hingde	hing	Irregular form plus regular suffix
hingden	hingen	Irregular form plus regular suffix
gehangd	gehangen	Overgeneralisation
ehangd	gehangen	Overgeneralisation+Prefix ge without onset
hangd	gehangen	Overgeneralisation+Lacking ge prefix
sehangd	gehangen	Overgeneralisation+prefix ge pronounced as se
gehangde	gehangene	Overgeneralisation+
ehangde	gehangene	Overgeneralisation+Prefix ge without onset
sehangde	gehangene	Overgeneralisation+prefix ge pronounced as se
gehangt	gehangen	Overgeneralisation
ehangt	gehangen	Overgeneralisation
hangt	gehangen	Overgeneralisation
ehangen	gehangen	Prefix ge without onset
hangen	gehangen	Lacking ge prefix
hebde	had	Overgeneralisation
hebden	hadden	Overgeneralisation
hadde	had	Irregular form plus regular suffix
gehebd	gehad	Overgeneralisation+
ehebd	gehad	Overgeneralisation+Prefix ge without onset
hebd	gehad	Overgeneralisation+Lacking ge prefix
sehebd	gehad	Overgeneralisation+prefix ge pronounced as se
gehebde	gehade	Overgeneralisation+
ehebde	gehade	Overgeneralisation+Prefix ge without onset
sehebde	gehade	Overgeneralisation+prefix ge pronounced as se
gehebt	gehad	Overgeneralisation
ehebt	gehad	Overgeneralisation
hebt	gehad	Overgeneralisation
gehebben	gehad	Wrong -en suffix
ehebben	gehad	Wrong -en suffix
hebben	gehad	Wrong -en suffix
ehad	gehad	Prefix ge without onset
had	gehad	Lacking ge prefix
hefte	hief	Overgeneralisation
heften	hieven	Overgeneralisation
hiefte	hief	Irregular form plus regular suffix
hieften	hieven	Irregular form plus regular suffix
geheft	geheven	Overgeneralisation
eheft	geheven	Overgeneralisation
heft	geheven	Overgeneralisation
seheft	geheven	Overgeneralisation+prefix ge pronounced as se
gehefte	gehevene	Overgeneralisation+
ehefte	gehevene	Overgeneralisation+Prefix ge without onset
sehefte	gehevene	Overgeneralisation+prefix ge pronounced as se
geheffen	geheven	Wrong -en suffix
eheffen	geheven	Wrong -en suffix
heffen	geheven	Wrong -en suffix
geheefd	geheven	Overgeneralisation
geheeft	geheven	Overgeneralisation
eheven	geheven	Prefix ge without onset
heven	geheven	Lacking ge prefix
helpte	hielp	Overgeneralisation
helpten	hielpen	Overgeneralisation
hielpte	hielp	Irregular form plus regular suffix
hielpten	hielpen	Irregular form plus regular suffix
gehelpt	geholpen	Overgeneralisation
ehelpt	geholpen	Overgeneralisation
helpt	geholpen	Overgeneralisation
sehelpt	geholpen	Overgeneralisation+prefix ge pronounced as se
gehelpte	geholpene	Overgeneralisation+
ehelpte	geholpene	Overgeneralisation+Prefix ge without onset
sehelpte	geholpene	Overgeneralisation+prefix ge pronounced as se
gehelpen	geholpen	Wrong -en suffix
ehelpen	geholpen	Wrong -en suffix
helpen	geholpen	Wrong -en suffix
geholpt	geholpen	Overgeneralisation
eholpen	geholpen	Prefix ge without onset
holpen	geholpen	Lacking ge prefix
geheet	geheten	Overgeneralisation
eheet	geheten	Overgeneralisation
heet	geheten	Overgeneralisation
seheet	geheten	Overgeneralisation+prefix ge pronounced as se
gehete	gehetene	Overgeneralisation+
ehete	gehetene	Overgeneralisation+Prefix ge without onset
sehete	gehetene	Overgeneralisation+prefix ge pronounced as se
eheten	geheten	Prefix ge without onset
heten	geheten	Lacking ge prefix
hijste	hees	Overgeneralisation
hijsten	hesen	Overgeneralisation
heeste	hees	Irregular form plus regular suffix
heesten	hesen	Irregular form plus regular suffix
gehijst	gehesen	Overgeneralisation
ehijst	gehesen	Overgeneralisation
hijst	gehesen	Overgeneralisation
sehijst	gehesen	Overgeneralisation+prefix ge pronounced as se
gehijste	gehesene	Overgeneralisation+
ehijste	gehesene	Overgeneralisation+Prefix ge without onset
sehijste	gehesene	Overgeneralisation+prefix ge pronounced as se
gehijsen	gehesen	Wrong -en suffix
ehijsen	gehesen	Wrong -en suffix
hijsen	gehesen	Wrong -en suffix
geheest	gehesen	Overgeneralisation
ehesen	gehesen	Prefix ge without onset
hesen	gehesen	Lacking ge prefix
gehoefd	gehoeven	Overgeneralisation
ehoefd	gehoeven	Overgeneralisation+Prefix ge without onset
hoefd	gehoeven	Overgeneralisation+Lacking ge prefix
sehoefd	gehoeven	Overgeneralisation+prefix ge pronounced as se
gehoefde	gehoevene	Overgeneralisation+
ehoefde	gehoevene	Overgeneralisation+Prefix ge without onset
sehoefde	gehoevene	Overgeneralisation+prefix ge pronounced as se
gehoeft	gehoeven	Overgeneralisation
ehoeft	gehoeven	Overgeneralisation
hoeft	gehoeven	Overgeneralisation
gehoefen	gehoeven	Wrong -en suffix
ehoefen	gehoeven	Wrong -en suffix
hoefen	gehoeven	Wrong -en suffix
ehoeven	gehoeven	Prefix ge without onset
hoeven	gehoeven	Lacking ge prefix
houdde	hield	Overgeneralisation
houdden	hielden	Overgeneralisation
hieldde	hield	Irregular form plus regular suffix
hieldden	hielden	Irregular form plus regular suffix
gehoud	gehouden	Overgeneralisation
ehoud	gehouden	Overgeneralisation
houd	gehouden	Overgeneralisation
sehoud	gehouden	Overgeneralisation+prefix ge pronounced as se
gehoude	gehoudene	Overgeneralisation+
ehoude	gehoudene	Overgeneralisation+Prefix ge without onset
sehoude	gehoudene	Overgeneralisation+prefix ge pronounced as se
ehouden	gehouden	Prefix ge without onset
houden	gehouden	Lacking ge prefix
houwde	hieuw	Overgeneralisation
houwden	hieuwen	Overgeneralisation
hieuwde	hieuw	Irregular form plus regular suffix
hieuwden	hieuwen	Irregular form plus regular suffix
gehouwd	gehouwen	Overgeneralisation
ehouwd	gehouwen	Overgeneralisation+Prefix ge without onset
houwd	gehouwen	Overgeneralisation+Lacking ge prefix
sehouwd	gehouwen	Overgeneralisation+prefix ge pronounced as se
gehouwde	gehouwene	Overgeneralisation+
ehouwde	gehouwene	Overgeneralisation+Prefix ge without onset
sehouwde	gehouwene	Overgeneralisation+prefix ge pronounced as se
gehouwt	gehouwen	Overgeneralisation
ehouwt	gehouwen	Overgeneralisation
houwt	gehouwen	Overgeneralisation
ehouwen	gehouwen	Prefix ge without onset
houwen	gehouwen	Lacking ge prefix
ejaagd	gejaagd	Prefix ge without onset
jaagd	gejaagd	Lacking ge prefix
sejaagd	gejaagd	Overgeneralisation+prefix ge pronounced as se
ejaagde	gejaagde	Overgeneralisation+Prefix ge without onset
sejaagde	gejaagde	Overgeneralisation+prefix ge pronounced as se
gejaagt	gejaagd	Overgeneralisation
ejaagt	gejaagd	Overgeneralisation
jaagt	gejaagd	Overgeneralisation
gejagen	gejaagd	Wrong -en suffix
ejagen	gejaagd	Wrong -en suffix
jagen	gejaagd	Wrong -en suffix
kiesde	koos	Overgeneralisation
kiesden	kozen	Overgeneralisation
koosde	koos	Irregular form plus regular suffix
koosden	kozen	Irregular form plus regular suffix
gekiesd	gekozen	Overgeneralisation+
ekiesd	gekozen	Overgeneralisation+Prefix ge without onset
kiesd	gekozen	Overgeneralisation+Lacking ge prefix
sekiesd	gekozen	Overgeneralisation+prefix ge pronounced as se
gekiesde	gekozene	Overgeneralisation+
ekiesde	gekozene	Overgeneralisation+Prefix ge without onset
sekiesde	gekozene	Overgeneralisation+prefix ge pronounced as se
gekiest	gekozen	Overgeneralisation
ekiest	gekozen	Overgeneralisation
kiest	gekozen	Overgeneralisation
gekiesen	gekozen	Wrong -en suffix
ekiesen	gekozen	Wrong -en suffix
kiesen	gekozen	Wrong -en suffix
gekoost	gekozen	Overgeneralisation
ekozen	gekozen	Prefix ge without onset
kozen	gekozen	Lacking ge prefix
kijkte	keek	Overgeneralisation
kijkten	keken	Overgeneralisation
keekte	keek	Irregular form plus regular suffix
keekten	keken	Irregular form plus regular suffix
gekijkt	gekeken	Overgeneralisation
ekijkt	gekeken	Overgeneralisation
kijkt	gekeken	Overgeneralisation
sekijkt	gekeken	Overgeneralisation+prefix ge pronounced as se
gekijkte	gekekene	Overgeneralisation+
ekijkte	gekekene	Overgeneralisation+Prefix ge without onset
sekijkte	gekekene	Overgeneralisation+prefix ge pronounced as se
gekijken	gekeken	Wrong -en suffix
ekijken	gekeken	Wrong -en suffix
kijken	gekeken	Wrong -en suffix
gekeekt	gekeken	Overgeneralisation
ekeken	gekeken	Prefix ge without onset
keken	gekeken	Lacking ge prefix
klimde	klom	Overgeneralisation
klimden	klommen	Overgeneralisation
klomde	klom	Irregular form plus regular suffix
klomden	klommen	Irregular form plus regular suffix
geklimd	geklommen	Overgeneralisation+
eklimd	geklommen	Overgeneralisation+Prefix ge without onset
klimd	geklommen	Overgeneralisation+Lacking ge prefix
seklimd	geklommen	Overgeneralisation+prefix ge pronounced as se
geklimde	geklommene	Overgeneralisation+
eklimde	geklommene	Overgeneralisation+Prefix ge without onset
seklimde	geklommene	Overgeneralisation+prefix ge pronounced as se
geklimt	geklommen	Overgeneralisation
eklimt	geklommen	Overgeneralisation
klimt	geklommen	Overgeneralisation
geklimmen	geklommen	Wrong -en suffix
eklimmen	geklommen	Wrong -en suffix
klimmen	geklommen	Wrong -en suffix
geklomt	geklommen	Overgeneralisation
eklommen	geklommen	Prefix ge without onset
klommen	geklommen	Lacking ge prefix
klinkte	klonk	Overgeneralisation
klinkten	klonken	Overgeneralisation
klonkte	klonk	Irregular form plus regular suffix
klonkten	klonken	Irregular form plus regular suffix
geklinkt	geklonken	Overgeneralisation
eklinkt	geklonken	Overgeneralisation
klinkt	geklonken	Overgeneralisation
seklinkt	geklonken	Overgeneralisation+prefix ge pronounced as se
geklinkte	geklonkene	Overgeneralisation+
eklinkte	geklonkene	Overgeneralisation+Prefix ge without onset
seklinkte	geklonkene	Overgeneralisation+prefix ge pronounced as se
geklinken	geklonken	Wrong -en suffix
eklinken	geklonken	Wrong -en suffix
klinken	geklonken	Wrong -en suffix
geklonkt	geklonken	Overgeneralisation
eklonken	geklonken	Prefix ge without onset
klonken	geklonken	Lacking ge prefix
kluifde	kloof	Overgeneralisation
kluifden	kloven	Overgeneralisation
kloofde	kloof	Irregular form plus regular suffix
kloofden	kloven	Irregular form plus regular suffix
gekluifd	gekloven	Overgeneralisation+
ekluifd	gekloven	Overgeneralisation+Prefix ge without onset
kluifd	gekloven	Overgeneralisation+Lacking ge prefix
sekluifd	gekloven	Overgeneralisation+prefix ge pronounced as se
gekluifde	geklovene	Overgeneralisation+
ekluifde	geklovene	Overgeneralisation+Prefix ge without onset
sekluifde	geklovene	Overgeneralisation+prefix ge pronounced as se
gekluift	gekloven	Overgeneralisation
ekluift	gekloven	Overgeneralisation
kluift	gekloven	Overgeneralisation
gekluifen	gekloven	Wrong -en suffix
ekluifen	gekloven	Wrong -en suffix
kluifen	gekloven	Wrong -en suffix
geklooft	gekloven	Overgeneralisation
ekloven	gekloven	Prefix ge without onset
kloven	gekloven	Lacking ge prefix
knijpte	kneep	Overgeneralisation
knijpten	knepen	Overgeneralisation
kneepte	kneep	Irregular form plus regular suffix
kneepten	knepen	Irregular form plus regular suffix
geknijpt	geknepen	Overgeneralisation
eknijpt	geknepen	Overgeneralisation
knijpt	geknepen	Overgeneralisation
seknijpt	geknepen	Overgeneralisation+prefix ge pronounced as se
geknijpte	geknepene	Overgeneralisation+
eknijpte	geknepene	Overgeneralisation+Prefix ge without onset
seknijpte	geknepene	Overgeneralisation+prefix ge pronounced as se
geknijpen	geknepen	Wrong -en suffix
eknijpen	geknepen	Wrong -en suffix
knijpen	geknepen	Wrong -en suffix
gekneept	geknepen	Overgeneralisation
eknepen	geknepen	Prefix ge without onset
knepen	geknepen	Lacking ge prefix
koomte	kwam	Overgeneralisation
koomten	kwamen	Overgeneralisation
kwamte	kwam	Irregular form plus regular suffix
kwamten	kwamen	Irregular form plus regular suffix
gekoomt	gekomen	Overgeneralisation
ekoomt	gekomen	Overgeneralisation
koomt	gekomen	Overgeneralisation
sekoomt	gekomen	Overgeneralisation+prefix ge pronounced as se
gekoomte	gekomene	Overgeneralisation+
ekoomte	gekomene	Overgeneralisation+Prefix ge without onset
sekoomte	gekomene	Overgeneralisation+prefix ge pronounced as se
ekomen	gekomen	Prefix ge without onset
komen	gekomen	Lacking ge prefix
koopte	kocht	Overgeneralisation
koopten	kochten	Overgeneralisation
kochtte	kocht	Irregular form plus regular suffix
kochtten	kochten	Irregular form plus regular suffix
gekoopt	gekocht	Overgeneralisation
ekoopt	gekocht	Overgeneralisation
koopt	gekocht	Overgeneralisation
sekoopt	gekocht	Overgeneralisation+prefix ge pronounced as se
gekoopte	gekochte	Overgeneralisation+
ekoopte	gekochte	Overgeneralisation+Prefix ge without onset
sekoopte	gekochte	Overgeneralisation+prefix ge pronounced as se
gekopen	gekocht	Wrong -en suffix
ekopen	gekocht	Wrong -en suffix
kopen	gekocht	Wrong -en suffix
ekocht	gekocht	Prefix ge without onset
kocht	gekocht	Lacking ge prefix
krijgde	kreeg	Overgeneralisation
krijgden	kregen	Overgeneralisation
kreegde	kreeg	Irregular form plus regular suffix
kreegden	kregen	Irregular form plus regular suffix
gekrijgd	gekregen	Overgeneralisation+
ekrijgd	gekregen	Overgeneralisation+Prefix ge without onset
krijgd	gekregen	Overgeneralisation+Lacking ge prefix
sekrijgd	gekregen	Overgeneralisation+prefix ge pronounced as se
gekrijgde	gekregene	Overgeneralisation+
ekrijgde	gekregene	Overgeneralisation+Prefix ge without onset
sekrijgde	gekregene	Overgeneralisation+prefix ge pronounced as se
gekrijgt	gekregen	Overgeneralisation
ekrijgt	gekregen	Overgeneralisation
krijgt	gekregen	Overgeneralisation
gekrijgen	gekregen	Wrong -en suffix
ekrijgen	gekregen	Wrong -en suffix
krijgen	gekregen	Wrong -en suffix
gekreegd	gekregen	Overgeneralisation
gekreegt	gekregen	Overgeneralisation
ekregen	gekregen	Prefix ge without onset
kregen	gekregen	Lacking ge prefix
krimpte	kromp	Overgeneralisation
krimpten	krompen	Overgeneralisation
krompte	kromp	Irregular form plus regular suffix
krompten	krompen	Irregular form plus regular suffix
gekrimpt	gekrompen	Overgeneralisation
ekrimpt	gekrompen	Overgeneralisation
krimpt	gekrompen	Overgeneralisation
sekrimpt	gekrompen	Overgeneralisation+prefix ge pronounced as se
gekrimpte	gekrompene	Overgeneralisation+
ekrimpte	gekrompene	Overgeneralisation+Prefix ge without onset
sekrimpte	gekrompene	Overgeneralisation+prefix ge pronounced as se
gekrimpen	gekrompen	Wrong -en suffix
ekrimpen	gekrompen	Wrong -en suffix
krimpen	gekrompen	Wrong -en suffix
gekrompt	gekrompen	Overgeneralisation
ekrompen	gekrompen	Prefix ge without onset
krompen	gekrompen	Lacking ge prefix
kruipte	kroop	Overgeneralisation
kruipten	kropen	Overgeneralisation
kroopte	kroop	Irregular form plus regular suffix
kroopten	kropen	Irregular form plus regular suffix
gekruipt	gekropen	Overgeneralisation
ekruipt	gekropen	Overgeneralisation
kruipt	gekropen	Overgeneralisation
sekruipt	gekropen	Overgeneralisation+prefix ge pronounced as se
gekruipte	gekropene	Overgeneralisation+
ekruipte	gekropene	Overgeneralisation+Prefix ge without onset
sekruipte	gekropene	Overgeneralisation+prefix ge pronounced as se
gekruipen	gekropen	Wrong -en suffix
ekruipen	gekropen	Wrong -en suffix
kruipen	gekropen	Wrong -en suffix
gekroopt	gekropen	Overgeneralisation
ekropen	gekropen	Prefix ge without onset
kropen	gekropen	Lacking ge prefix
kwijtte	kweet	Overgeneralisation
kwijtten	kweten	Overgeneralisation
kweette	kweet	Irregular form plus regular suffix
kweetten	kweten	Irregular form plus regular suffix
gekwijt	gekweten	Overgeneralisation
ekwijt	gekweten	Overgeneralisation
kwijt	gekweten	Overgeneralisation
sekwijt	gekweten	Overgeneralisation+prefix ge pronounced as se
gekwijte	gekwetene	Overgeneralisation+
ekwijte	gekwetene	Overgeneralisation+Prefix ge without onset
sekwijte	gekwetene	Overgeneralisation+prefix ge pronounced as se
gekwijten	gekweten	Wrong -en suffix
ekwijten	gekweten	Wrong -en suffix
kwijten	gekweten	Wrong -en suffix
gekweet	gekweten	Overgeneralisation
ekweten	gekweten	Prefix ge without onset
kweten	gekweten	Lacking ge prefix
lachde	lachte	Overgeneralisation
lachden	lachten	Overgeneralisation
gelachd	gelachen	Overgeneralisation
elachd	gelachen	Overgeneralisation+Prefix ge without onset
lachd	gelachen	Overgeneralisation+Lacking ge prefix
selachd	gelachen	Overgeneralisation+prefix ge pronounced as se
gelachde	gelachene	Overgeneralisation+
elachde	gelachene	Overgeneralisation+Prefix ge without onset
selachde	gelachene	Overgeneralisation+prefix ge pronounced as se
gelacht	gelachen	Overgeneralisation
elacht	gelachen	Overgeneralisation
lacht	gelachen	Overgeneralisation
elachen	gelachen	Prefix ge without onset
lachen	gelachen	Lacking ge prefix
gelaad	geladen	Overgeneralisation
elaad	geladen	Overgeneralisation
laad	geladen	Overgeneralisation
selaad	geladen	Overgeneralisation+prefix ge pronounced as se
gelade	geladene	Overgeneralisation+
elade	geladene	Overgeneralisation+Prefix ge without onset
selade	geladene	Overgeneralisation+prefix ge pronounced as se
eladen	geladen	Prefix ge without onset
laden	geladen	Lacking ge prefix
laatte	liet	Overgeneralisation
laatten	lieten	Overgeneralisation
liette	liet	Irregular form plus regular suffix
lietten	lieten	Irregular form plus regular suffix
gelaat	gelaten	Overgeneralisation
elaat	gelaten	Overgeneralisation
laat	gelaten	Overgeneralisation
selaat	gelaten	Overgeneralisation+prefix ge pronounced as se
gelate	gelatene	Overgeneralisation+
elate	gelatene	Overgeneralisation+Prefix ge without onset
selate	gelatene	Overgeneralisation+prefix ge pronounced as se
elaten	gelaten	Prefix ge without onset
laten	gelaten	Lacking ge prefix
leesde	las	Overgeneralisation
leesden	lazen	Overgeneralisation
lasde	las	Irregular form plus regular suffix
lasden	lazen	Irregular form plus regular suffix
geleesd	gelezen	Overgeneralisation
eleesd	gelezen	Overgeneralisation+Prefix ge without onset
leesd	gelezen	Overgeneralisation+Lacking ge prefix
seleesd	gelezen	Overgeneralisation+prefix ge pronounced as se
geleesde	gelezene	Overgeneralisation+
eleesde	gelezene	Overgeneralisation+Prefix ge without onset
seleesde	gelezene	Overgeneralisation+prefix ge pronounced as se
geleest	gelezen	Overgeneralisation
eleest	gelezen	Overgeneralisation
leest	gelezen	Overgeneralisation
gelesen	gelezen	Wrong -en suffix
elesen	gelezen	Wrong -en suffix
lesen	gelezen	Wrong -en suffix
elezen	gelezen	Prefix ge without onset
lezen	gelezen	Lacking ge prefix
liegde	loog	Overgeneralisation
liegden	logen	Overgeneralisation
loogde	loog	Irregular form plus regular suffix
loogden	logen	Irregular form plus regular suffix
geliegd	gelogen	Overgeneralisation+
eliegd	gelogen	Overgeneralisation+Prefix ge without onset
liegd	gelogen	Overgeneralisation+Lacking ge prefix
seliegd	gelogen	Overgeneralisation+prefix ge pronounced as se
geliegde	gelogene	Overgeneralisation+
eliegde	gelogene	Overgeneralisation+Prefix ge without onset
seliegde	gelogene	Overgeneralisation+prefix ge pronounced as se
geliegt	gelogen	Overgeneralisation
eliegt	gelogen	Overgeneralisation
liegt	gelogen	Overgeneralisation
geliegen	gelogen	Wrong -en suffix
eliegen	gelogen	Wrong -en suffix
liegen	gelogen	Wrong -en suffix
geloogt	gelogen	Overgeneralisation
elogen	gelogen	Prefix ge without onset
logen	gelogen	Lacking ge prefix
ligde	lag	Overgeneralisation
ligden	lagen	Overgeneralisation
lagde	lag	Irregular form plus regular suffix
lagden	lagen	Irregular form plus regular suffix
geligd	gelegen	Overgeneralisation+
eligd	gelegen	Overgeneralisation+Prefix ge without onset
ligd	gelegen	Overgeneralisation+Lacking ge prefix
seligd	gelegen	Overgeneralisation+prefix ge pronounced as se
geligde	gelegene	Overgeneralisation+
eligde	gelegene	Overgeneralisation+Prefix ge without onset
seligde	gelegene	Overgeneralisation+prefix ge pronounced as se
geligt	gelegen	Overgeneralisation
eligt	gelegen	Overgeneralisation
ligt	gelegen	Overgeneralisation
geliggen	gelegen	Wrong -en suffix
eliggen	gelegen	Wrong -en suffix
liggen	gelegen	Wrong -en suffix
geleegd	gelegen	Overgeneralisation
geleegt	gelegen	Overgeneralisation
elegen	gelegen	Prefix ge without onset
legen	gelegen	Lacking ge prefix
lijdde	leed	Overgeneralisation
lijdden	leden	Overgeneralisation
leedde	leed	Irregular form plus regular suffix
leedden	leden	Irregular form plus regular suffix
gelijd	geleden	Overgeneralisation
elijd	geleden	Overgeneralisation
lijd	geleden	Overgeneralisation
selijd	geleden	Overgeneralisation+prefix ge pronounced as se
gelijde	geledene	Overgeneralisation+
elijde	geledene	Overgeneralisation+Prefix ge without onset
selijde	geledene	Overgeneralisation+prefix ge pronounced as se
gelijden	geleden	Wrong -en suffix
elijden	geleden	Wrong -en suffix
lijden	geleden	Wrong -en suffix
geleed	geleden	Overgeneralisation
eleden	geleden	Prefix ge without onset
leden	geleden	Lacking ge prefix
lijkte	leek	Overgeneralisation
lijkten	leken	Overgeneralisation
leekte	leek	Irregular form plus regular suffix
leekten	leken	Irregular form plus regular suffix
gelijkt	geleken	Overgeneralisation
elijkt	geleken	Overgeneralisation
lijkt	geleken	Overgeneralisation
selijkt	geleken	Overgeneralisation+prefix ge pronounced as se
gelijkte	gelekene	Overgeneralisation+
elijkte	gelekene	Overgeneralisation+Prefix ge without onset
selijkte	gelekene	Overgeneralisation+prefix ge pronounced as se
gelijken	geleken	Wrong -en suffix
elijken	geleken	Wrong -en suffix
lijken	geleken	Wrong -en suffix
geleekt	geleken	Overgeneralisation
eleken	geleken	Prefix ge without onset
leken	geleken	Lacking ge prefix
loopte	liep	Overgeneralisation
loopten	liepen	Overgeneralisation
liepte	liep	Irregular form plus regular suffix
liepten	liepen	Irregular form plus regular suffix
geloopt	gelopen	Overgeneralisation
eloopt	gelopen	Overgeneralisation
loopt	gelopen	Overgeneralisation
seloopt	gelopen	Overgeneralisation+prefix ge pronounced as se
geloopte	gelopene	Overgeneralisation+
eloopte	gelopene	Overgeneralisation+Prefix ge without onset
seloopte	gelopene	Overgeneralisation+prefix ge pronounced as se
elopen	gelopen	Prefix ge without onset
lopen	gelopen	Lacking ge prefix
gemaald	gemalen	Overgeneralisation
emaald	gemalen	Overgeneralisation+Prefix ge without onset
maald	gemalen	Overgeneralisation+Lacking ge prefix
semaald	gemalen	Overgeneralisation+prefix ge pronounced as se
gemaalde	gemalene	Overgeneralisation+
emaalde	gemalene	Overgeneralisation+Prefix ge without onset
semaalde	gemalene	Overgeneralisation+prefix ge pronounced as se
gemaalt	gemalen	Overgeneralisation
emaalt	gemalen	Overgeneralisation
maalt	gemalen	Overgeneralisation
emalen	gemalen	Prefix ge without onset
malen	gemalen	Lacking ge prefix
emelkt	gemelkt	Prefix ge without onset
melkt	gemelkt	Lacking ge prefix
semelkt	gemelkt	Overgeneralisation+prefix ge pronounced as se
emelkte	gemelkte	Overgeneralisation+Prefix ge without onset
semelkte	gemelkte	Overgeneralisation+prefix ge pronounced as se
gemelken	gemelkt	Wrong -en suffix
emelken	gemelkt	Wrong -en suffix
melken	gemelkt	Wrong -en suffix
meette	mat	Overgeneralisation
meetten	maten	Overgeneralisation
matte	mat	Irregular form plus regular suffix
matten	maten	Irregular form plus regular suffix
gemeet	gemeten	Overgeneralisation
emeet	gemeten	Overgeneralisation
meet	gemeten	Overgeneralisation
semeet	gemeten	Overgeneralisation+prefix ge pronounced as se
gemete	gemetene	Overgeneralisation+
emete	gemetene	Overgeneralisation+Prefix ge without onset
semete	gemetene	Overgeneralisation+prefix ge pronounced as se
emeten	gemeten	Prefix ge without onset
meten	gemeten	Lacking ge prefix
mijdde	meed	Overgeneralisation
mijdden	meden	Overgeneralisation
meedde	meed	Irregular form plus regular suffix
meedden	meden	Irregular form plus regular suffix
gemijd	gemeden	Overgeneralisation
emijd	gemeden	Overgeneralisation
mijd	gemeden	Overgeneralisation
semijd	gemeden	Overgeneralisation+prefix ge pronounced as se
gemijde	gemedene	Overgeneralisation+
emijde	gemedene	Overgeneralisation+Prefix ge without onset
semijde	gemedene	Overgeneralisation+prefix ge pronounced as se
gemijden	gemeden	Wrong -en suffix
emijden	gemeden	Wrong -en suffix
mijden	gemeden	Wrong -en suffix
gemeed	gemeden	Overgeneralisation
emeden	gemeden	Prefix ge without onset
meden	gemeden	Lacking ge prefix
moette	moest	Overgeneralisation
moetten	moesten	Overgeneralisation
moestte	moest	Irregular form plus regular suffix
moestten	moesten	Irregular form plus regular suffix
gemoet	gemoeten	Overgeneralisation
emoet	gemoeten	Overgeneralisation
moet	gemoeten	Overgeneralisation
semoet	gemoeten	Overgeneralisation+prefix ge pronounced as se
gemoete	gemoetene	Overgeneralisation+
emoete	gemoetene	Overgeneralisation+Prefix ge without onset
semoete	gemoetene	Overgeneralisation+prefix ge pronounced as se
emoeten	gemoeten	Prefix ge without onset
moeten	gemoeten	Lacking ge prefix
neemde	nam	Overgeneralisation
neemden	namen	Overgeneralisation
namde	nam	Irregular form plus regular suffix
namden	namen	Irregular form plus regular suffix
geneemd	genomen	Overgeneralisation+
eneemd	genomen	Overgeneralisation+Prefix ge without onset
neemd	genomen	Overgeneralisation+Lacking ge prefix
seneemd	genomen	Overgeneralisation+prefix ge pronounced as se
geneemde	genomene	Overgeneralisation+
eneemde	genomene	Overgeneralisation+Prefix ge without onset
seneemde	genomene	Overgeneralisation+prefix ge pronounced as se
geneemt	genomen	Overgeneralisation
eneemt	genomen	Overgeneralisation
neemt	genomen	Overgeneralisation
genemen	genomen	Wrong -en suffix
enemen	genomen	Wrong -en suffix
nemen	genomen	Wrong -en suffix
genoomt	genomen	Overgeneralisation
enomen	genomen	Prefix ge without onset
nomen	genomen	Lacking ge prefix
nijgde	neeg	Overgeneralisation
nijgden	negen	Overgeneralisation
neegde	neeg	Irregular form plus regular suffix
neegden	negen	Irregular form plus regular suffix
genijgd	genegen	Overgeneralisation+
enijgd	genegen	Overgeneralisation+Prefix ge without onset
nijgd	genegen	Overgeneralisation+Lacking ge prefix
senijgd	genegen	Overgeneralisation+prefix ge pronounced as se
genijgde	genegene	Overgeneralisation+
enijgde	genegene	Overgeneralisation+Prefix ge without onset
senijgde	genegene	Overgeneralisation+prefix ge pronounced as se
genijgt	genegen	Overgeneralisation
enijgt	genegen	Overgeneralisation
nijgt	genegen	Overgeneralisation
genijgen	genegen	Wrong -en suffix
enijgen	genegen	Wrong -en suffix
nijgen	genegen	Wrong -en suffix
geneegd	genegen	Overgeneralisation
geneegt	genegen	Overgeneralisation
enegen	genegen	Prefix ge without onset
negen	genegen	Lacking ge prefix
ontginde	ontgonnene	Overgeneralisation
ontginden	ontgonnen	Overgeneralisation
ontgonde	ontgon	Irregular form plus regular suffix
ontgonden	ontgonnen	Irregular form plus regular suffix
ontgind	ontgonnen	Overgeneralisation
ontgint	ontgonnen	Overgeneralisation
ontginnen	ontgonnen	Wrong -en suffix
ontgont	ontgonnen	Overgeneralisation
ontluikte	ontlokene	Overgeneralisation
ontluikten	ontloken	Overgeneralisation
ontlookte	ontlook	Irregular form plus regular suffix
ontlookten	ontloken	Irregular form plus regular suffix
ontluikt	ontloken	Overgeneralisation
ontluiken	ontloken	Wrong -en suffix
ontlookt	ontloken	Overgeneralisation
pluisde	ploos	Overgeneralisation
pluisden	plozen	Overgeneralisation
ploosde	ploos	Irregular form plus regular suffix
ploosden	plozen	Irregular form plus regular suffix
gepluisd	geplozen	Overgeneralisation+
epluisd	geplozen	Overgeneralisation+Prefix ge without onset
pluisd	geplozen	Overgeneralisation+Lacking ge prefix
sepluisd	geplozen	Overgeneralisation+prefix ge pronounced as se
gepluisde	geplozene	Overgeneralisation+
epluisde	geplozene	Overgeneralisation+Prefix ge without onset
sepluisde	geplozene	Overgeneralisation+prefix ge pronounced as se
gepluist	geplozen	Overgeneralisation
epluist	geplozen	Overgeneralisation
pluist	geplozen	Overgeneralisation
gepluisen	geplozen	Wrong -en suffix
epluisen	geplozen	Wrong -en suffix
pluisen	geplozen	Wrong -en suffix
geploost	geplozen	Overgeneralisation
eplozen	geplozen	Prefix ge without onset
plozen	geplozen	Lacking ge prefix
prijsde	prees	Overgeneralisation
prijsden	prezen	Overgeneralisation
preesde	prees	Irregular form plus regular suffix
preesden	prezen	Irregular form plus regular suffix
geprijsd	geprezen	Overgeneralisation+
eprijsd	geprezen	Overgeneralisation+Prefix ge without onset
prijsd	geprezen	Overgeneralisation+Lacking ge prefix
seprijsd	geprezen	Overgeneralisation+prefix ge pronounced as se
geprijsde	geprezene	Overgeneralisation+
eprijsde	geprezene	Overgeneralisation+Prefix ge without onset
seprijsde	geprezene	Overgeneralisation+prefix ge pronounced as se
geprijst	geprezen	Overgeneralisation
eprijst	geprezen	Overgeneralisation
prijst	geprezen	Overgeneralisation
geprijsen	geprezen	Wrong -en suffix
eprijsen	geprezen	Wrong -en suffix
prijsen	geprezen	Wrong -en suffix
gepreesd	geprezen	Overgeneralisation
gepreest	geprezen	Overgeneralisation
eprezen	geprezen	Prefix ge without onset
prezen	geprezen	Lacking ge prefix
geraad	geraden	Overgeneralisation
eraad	geraden	Overgeneralisation
raad	geraden	Overgeneralisation
seraad	geraden	Overgeneralisation+prefix ge pronounced as se
gerade	geradene	Overgeneralisation+
erade	geradene	Overgeneralisation+Prefix ge without onset
serade	geradene	Overgeneralisation+prefix ge pronounced as se
eraden	geraden	Prefix ge without onset
raden	geraden	Lacking ge prefix
verraad	verraden	Overgeneralisation
verrade	verradene	Overgeneralisation
rijdde	reed	Overgeneralisation
rijdden	reden	Overgeneralisation
reedde	reed	Irregular form plus regular suffix
reedden	reden	Irregular form plus regular suffix
gerijd	gereden	Overgeneralisation
erijd	gereden	Overgeneralisation
rijd	gereden	Overgeneralisation
serijd	gereden	Overgeneralisation+prefix ge pronounced as se
gerijde	geredene	Overgeneralisation+
erijde	geredene	Overgeneralisation+Prefix ge without onset
serijde	geredene	Overgeneralisation+prefix ge pronounced as se
gerijden	gereden	Wrong -en suffix
erijden	gereden	Wrong -en suffix
rijden	gereden	Wrong -en suffix
gereed	gereden	Overgeneralisation
ereden	gereden	Prefix ge without onset
reden	gereden	Lacking ge prefix
rijgde	reeg	Overgeneralisation
rijgden	regen	Overgeneralisation
reegde	reeg	Irregular form plus regular suffix
reegden	regen	Irregular form plus regular suffix
gerijgd	geregen	Overgeneralisation+
erijgd	geregen	Overgeneralisation+Prefix ge without onset
rijgd	geregen	Overgeneralisation+Lacking ge prefix
serijgd	geregen	Overgeneralisation+prefix ge pronounced as se
gerijgde	geregene	Overgeneralisation+
erijgde	geregene	Overgeneralisation+Prefix ge without onset
serijgde	geregene	Overgeneralisation+prefix ge pronounced as se
gerijgt	geregen	Overgeneralisation
erijgt	geregen	Overgeneralisation
rijgt	geregen	Overgeneralisation
gerijgen	geregen	Wrong -en suffix
erijgen	geregen	Wrong -en suffix
rijgen	geregen	Wrong -en suffix
gereegd	geregen	Overgeneralisation
gereegt	geregen	Overgeneralisation
eregen	geregen	Prefix ge without onset
regen	geregen	Lacking ge prefix
rijtte	reet	Overgeneralisation
rijtten	reten	Overgeneralisation
reette	reet	Irregular form plus regular suffix
reetten	reten	Irregular form plus regular suffix
gerijt	gereten	Overgeneralisation
erijt	gereten	Overgeneralisation
rijt	gereten	Overgeneralisation
serijt	gereten	Overgeneralisation+prefix ge pronounced as se
gerijte	geretene	Overgeneralisation+
erijte	geretene	Overgeneralisation+Prefix ge without onset
serijte	geretene	Overgeneralisation+prefix ge pronounced as se
gerijten	gereten	Wrong -en suffix
erijten	gereten	Wrong -en suffix
rijten	gereten	Wrong -en suffix
gereet	gereten	Overgeneralisation
ereten	gereten	Prefix ge without onset
reten	gereten	Lacking ge prefix
rijsde	rees	Overgeneralisation
rijsden	rezen	Overgeneralisation
reesde	rees	Irregular form plus regular suffix
reesden	rezen	Irregular form plus regular suffix
gerijsd	Gerezen	Overgeneralisation+
erijsd	Gerezen	Overgeneralisation+Prefix ge without onset
rijsd	Gerezen	Overgeneralisation+Lacking ge prefix
serijsd	Gerezen	Overgeneralisation+prefix ge pronounced as se
gerijsde	Gerezene	Overgeneralisation+
erijsde	Gerezene	Overgeneralisation+Prefix ge without onset
serijsde	Gerezene	Overgeneralisation+prefix ge pronounced as se
gerijst	Gerezen	Overgeneralisation
erijst	Gerezen	Overgeneralisation
rijst	Gerezen	Overgeneralisation
gerijsen	Gerezen	Wrong -en suffix
erijsen	Gerezen	Wrong -en suffix
rijsen	Gerezen	Wrong -en suffix
geGereesd	Gerezen	Overgeneralisation
geGereest	Gerezen	Overgeneralisation
roepte	riep	Overgeneralisation
roepten	riepen	Overgeneralisation
riepte	riep	Irregular form plus regular suffix
riepten	riepen	Irregular form plus regular suffix
geroept	geroepen	Overgeneralisation
eroept	geroepen	Overgeneralisation
roept	geroepen	Overgeneralisation
seroept	geroepen	Overgeneralisation+prefix ge pronounced as se
geroepte	geroepene	Overgeneralisation+
eroepte	geroepene	Overgeneralisation+Prefix ge without onset
seroepte	geroepene	Overgeneralisation+prefix ge pronounced as se
eroepen	geroepen	Prefix ge without onset
roepen	geroepen	Lacking ge prefix
ruikte	rook	Overgeneralisation
ruikten	roken	Overgeneralisation
rookte	rook	Irregular form plus regular suffix
rookten	roken	Irregular form plus regular suffix
geruikt	geroken	Overgeneralisation
eruikt	geroken	Overgeneralisation
ruikt	geroken	Overgeneralisation
seruikt	geroken	Overgeneralisation+prefix ge pronounced as se
geruikte	gerokene	Overgeneralisation+
eruikte	gerokene	Overgeneralisation+Prefix ge without onset
seruikte	gerokene	Overgeneralisation+prefix ge pronounced as se
geruiken	geroken	Wrong -en suffix
eruiken	geroken	Wrong -en suffix
ruiken	geroken	Wrong -en suffix
gerookt	geroken	Overgeneralisation
eroken	geroken	Prefix ge without onset
roken	geroken	Lacking ge prefix
gescheid	gescheiden	Overgeneralisation
escheid	gescheiden	Overgeneralisation
scheid	gescheiden	Overgeneralisation
sescheid	gescheiden	Overgeneralisation+prefix ge pronounced as se
gescheide	gescheidene	Overgeneralisation+
escheide	gescheidene	Overgeneralisation+Prefix ge without onset
sescheide	gescheidene	Overgeneralisation+prefix ge pronounced as se
escheiden	gescheiden	Prefix ge without onset
scheiden	gescheiden	Lacking ge prefix
scheldde	schold	Overgeneralisation
scheldden	scholden	Overgeneralisation
scholdde	schold	Irregular form plus regular suffix
scholdden	scholden	Irregular form plus regular suffix
gescheld	gescholden	Overgeneralisation
escheld	gescholden	Overgeneralisation
scheld	gescholden	Overgeneralisation
sescheld	gescholden	Overgeneralisation+prefix ge pronounced as se
geschelde	gescholdene	Overgeneralisation+
eschelde	gescholdene	Overgeneralisation+Prefix ge without onset
seschelde	gescholdene	Overgeneralisation+prefix ge pronounced as se
geschelden	gescholden	Wrong -en suffix
eschelden	gescholden	Wrong -en suffix
schelden	gescholden	Wrong -en suffix
geschold	gescholden	Overgeneralisation
escholden	gescholden	Prefix ge without onset
scholden	gescholden	Lacking ge prefix
schendde	schond	Overgeneralisation
schendden	schonden	Overgeneralisation
schondde	schond	Irregular form plus regular suffix
schondden	schonden	Irregular form plus regular suffix
geschend	geschonden	Overgeneralisation
eschend	geschonden	Overgeneralisation
schend	geschonden	Overgeneralisation
seschend	geschonden	Overgeneralisation+prefix ge pronounced as se
geschende	geschondene	Overgeneralisation+
eschende	geschondene	Overgeneralisation+Prefix ge without onset
seschende	geschondene	Overgeneralisation+prefix ge pronounced as se
geschenden	geschonden	Wrong -en suffix
eschenden	geschonden	Wrong -en suffix
schenden	geschonden	Wrong -en suffix
geschond	geschonden	Overgeneralisation
eschonden	geschonden	Prefix ge without onset
schonden	geschonden	Lacking ge prefix
schenkte	schonk	Overgeneralisation
schenkten	schonken	Overgeneralisation
schonkte	schonk	Irregular form plus regular suffix
schonkten	schonken	Irregular form plus regular suffix
geschenkt	geschonken	Overgeneralisation
eschenkt	geschonken	Overgeneralisation
schenkt	geschonken	Overgeneralisation
seschenkt	geschonken	Overgeneralisation+prefix ge pronounced as se
geschenkte	geschonkene	Overgeneralisation+
eschenkte	geschonkene	Overgeneralisation+Prefix ge without onset
seschenkte	geschonkene	Overgeneralisation+prefix ge pronounced as se
geschenken	geschonken	Wrong -en suffix
eschenken	geschonken	Wrong -en suffix
schenken	geschonken	Wrong -en suffix
geschonkt	geschonken	Overgeneralisation
eschonken	geschonken	Prefix ge without onset
schonken	geschonken	Lacking ge prefix
schepte	shiep	Overgeneralisation
schepten	schiepen	Overgeneralisation
shiepte	shiep	Irregular form plus regular suffix
shiepten	schiepen	Irregular form plus regular suffix
geschept	geschapen	Overgeneralisation
eschept	geschapen	Overgeneralisation
schept	geschapen	Overgeneralisation
seschept	geschapen	Overgeneralisation+prefix ge pronounced as se
geschepte	geschapene	Overgeneralisation+
eschepte	geschapene	Overgeneralisation+Prefix ge without onset
seschepte	geschapene	Overgeneralisation+prefix ge pronounced as se
gescheppen	geschapen	Wrong -en suffix
escheppen	geschapen	Wrong -en suffix
scheppen	geschapen	Wrong -en suffix
geschaapt	geschapen	Overgeneralisation
eschapen	geschapen	Prefix ge without onset
schapen	geschapen	Lacking ge prefix
gescheerd	geschoren	Overgeneralisation+
escheerd	geschoren	Overgeneralisation+Prefix ge without onset
scheerd	geschoren	Overgeneralisation+Lacking ge prefix
sescheerd	geschoren	Overgeneralisation+prefix ge pronounced as se
gescheerde	geschorene	Overgeneralisation+
escheerde	geschorene	Overgeneralisation+Prefix ge without onset
sescheerde	geschorene	Overgeneralisation+prefix ge pronounced as se
gescheert	geschoren	Overgeneralisation
escheert	geschoren	Overgeneralisation
scheert	geschoren	Overgeneralisation
gescheren	geschoren	Wrong -en suffix
escheren	geschoren	Wrong -en suffix
scheren	geschoren	Wrong -en suffix
geschoort	geschoren	Overgeneralisation
eschoren	geschoren	Prefix ge without onset
schoren	geschoren	Lacking ge prefix
schiette	schoot	Overgeneralisation
schietten	schoten	Overgeneralisation
schootte	schoot	Irregular form plus regular suffix
schootten	schoten	Irregular form plus regular suffix
geschiet	geschoten	Overgeneralisation
eschiet	geschoten	Overgeneralisation
schiet	geschoten	Overgeneralisation
seschiet	geschoten	Overgeneralisation+prefix ge pronounced as se
geschiete	geschotene	Overgeneralisation+
eschiete	geschotene	Overgeneralisation+Prefix ge without onset
seschiete	geschotene	Overgeneralisation+prefix ge pronounced as se
geschieten	geschoten	Wrong -en suffix
eschieten	geschoten	Wrong -en suffix
schieten	geschoten	Wrong -en suffix
geschoot	geschoten	Overgeneralisation
eschoten	geschoten	Prefix ge without onset
schoten	geschoten	Lacking ge prefix
schijnde	scheen	Overgeneralisation
schijnden	schenen	Overgeneralisation
scheende	scheen	Irregular form plus regular suffix
scheenden	schenen	Irregular form plus regular suffix
geschijnd	geschenen	Overgeneralisation+
eschijnd	geschenen	Overgeneralisation+Prefix ge without onset
schijnd	geschenen	Overgeneralisation+Lacking ge prefix
seschijnd	geschenen	Overgeneralisation+prefix ge pronounced as se
geschijnde	geschenene	Overgeneralisation+
eschijnde	geschenene	Overgeneralisation+Prefix ge without onset
seschijnde	geschenene	Overgeneralisation+prefix ge pronounced as se
geschijnt	geschenen	Overgeneralisation
eschijnt	geschenen	Overgeneralisation
schijnt	geschenen	Overgeneralisation
geschijnen	geschenen	Wrong -en suffix
eschijnen	geschenen	Wrong -en suffix
schijnen	geschenen	Wrong -en suffix
gescheend	geschenen	Overgeneralisation
gescheent	geschenen	Overgeneralisation
eschenen	geschenen	Prefix ge without onset
schenen	geschenen	Lacking ge prefix
schijtte	scheet	Overgeneralisation
schijtten	scheten	Overgeneralisation
scheette	scheet	Irregular form plus regular suffix
scheetten	scheten	Irregular form plus regular suffix
geschijt	gescheten	Overgeneralisation
eschijt	gescheten	Overgeneralisation
schijt	gescheten	Overgeneralisation
seschijt	gescheten	Overgeneralisation+prefix ge pronounced as se
geschijte	geschetene	Overgeneralisation+
eschijte	geschetene	Overgeneralisation+Prefix ge without onset
seschijte	geschetene	Overgeneralisation+prefix ge pronounced as se
geschijten	gescheten	Wrong -en suffix
eschijten	gescheten	Wrong -en suffix
schijten	gescheten	Wrong -en suffix
gescheet	gescheten	Overgeneralisation
escheten	gescheten	Prefix ge without onset
scheten	gescheten	Lacking ge prefix
schrijfde	schreef	Overgeneralisation
schrijfden	schreven	Overgeneralisation
schreefde	schreef	Irregular form plus regular suffix
schreefden	schreven	Irregular form plus regular suffix
geschrijfd	geschreven	Overgeneralisation+
eschrijfd	geschreven	Overgeneralisation+Prefix ge without onset
schrijfd	geschreven	Overgeneralisation+Lacking ge prefix
seschrijfd	geschreven	Overgeneralisation+prefix ge pronounced as se
geschrijfde	geschrevene	Overgeneralisation+
eschrijfde	geschrevene	Overgeneralisation+Prefix ge without onset
seschrijfde	geschrevene	Overgeneralisation+prefix ge pronounced as se
geschrijft	geschreven	Overgeneralisation
eschrijft	geschreven	Overgeneralisation
schrijft	geschreven	Overgeneralisation
geschrijfen	geschreven	Wrong -en suffix
eschrijfen	geschreven	Wrong -en suffix
schrijfen	geschreven	Wrong -en suffix
geschreefd	geschreven	Overgeneralisation
geschreeft	geschreven	Overgeneralisation
eschreven	geschreven	Prefix ge without onset
schreven	geschreven	Lacking ge prefix
schrikte	schrok	Overgeneralisation
schrikten	schrokken	Overgeneralisation
schrokte	schrok	Irregular form plus regular suffix
schrokten	schrokken	Irregular form plus regular suffix
geschrikt	geschrokken	Overgeneralisation
eschrikt	geschrokken	Overgeneralisation
schrikt	geschrokken	Overgeneralisation
seschrikt	geschrokken	Overgeneralisation+prefix ge pronounced as se
geschrikte	geschrokkene	Overgeneralisation+
eschrikte	geschrokkene	Overgeneralisation+Prefix ge without onset
seschrikte	geschrokkene	Overgeneralisation+prefix ge pronounced as se
geschrikken	geschrokken	Wrong -en suffix
eschrikken	geschrokken	Wrong -en suffix
schrikken	geschrokken	Wrong -en suffix
geschrokt	geschrokken	Overgeneralisation
eschrokken	geschrokken	Prefix ge without onset
schrokken	geschrokken	Lacking ge prefix
eschuild	geschuild	Prefix ge without onset
schuild	geschuild	Lacking ge prefix
seschuild	geschuild	Overgeneralisation+prefix ge pronounced as se
eschuilde	geschuilde	Overgeneralisation+Prefix ge without onset
seschuilde	geschuilde	Overgeneralisation+prefix ge pronounced as se
geschuilt	geschuild	Overgeneralisation
eschuilt	geschuild	Overgeneralisation
schuilt	geschuild	Overgeneralisation
geschuilen	geschuild	Wrong -en suffix
eschuilen	geschuild	Wrong -en suffix
schuilen	geschuild	Wrong -en suffix
schuifde	schoof	Overgeneralisation
schuifden	schoven	Overgeneralisation
schoofde	schoof	Irregular form plus regular suffix
schoofden	schoven	Irregular form plus regular suffix
geschuifd	geschoven	Overgeneralisation+
eschuifd	geschoven	Overgeneralisation+Prefix ge without onset
schuifd	geschoven	Overgeneralisation+Lacking ge prefix
seschuifd	geschoven	Overgeneralisation+prefix ge pronounced as se
geschuifde	geschovene	Overgeneralisation+
eschuifde	geschovene	Overgeneralisation+Prefix ge without onset
seschuifde	geschovene	Overgeneralisation+prefix ge pronounced as se
geschuift	geschoven	Overgeneralisation
eschuift	geschoven	Overgeneralisation
schuift	geschoven	Overgeneralisation
geschuifen	geschoven	Wrong -en suffix
eschuifen	geschoven	Wrong -en suffix
schuifen	geschoven	Wrong -en suffix
geschooft	geschoven	Overgeneralisation
eschoven	geschoven	Prefix ge without onset
schoven	geschoven	Lacking ge prefix
slade	sloeg	Overgeneralisation
sladen	sloegen	Overgeneralisation
sloegde	sloeg	Irregular form plus regular suffix
sloegden	sloegen	Irregular form plus regular suffix
geslaad	geslagen	Overgeneralisation+
eslaad	geslagen	Overgeneralisation+Prefix ge without onset
slaad	geslagen	Overgeneralisation+Lacking ge prefix
seslaad	geslagen	Overgeneralisation+prefix ge pronounced as se
geslade	geslagene	Overgeneralisation+
eslade	geslagene	Overgeneralisation+Prefix ge without onset
seslade	geslagene	Overgeneralisation+prefix ge pronounced as se
geslaat	geslagen	Overgeneralisation
eslaat	geslagen	Overgeneralisation
slaat	geslagen	Overgeneralisation
geslaan	geslagen	Wrong -en suffix
eslaan	geslagen	Wrong -en suffix
slaan	geslagen	Wrong -en suffix
geslaagd	geslagen	Overgeneralisation
geslaagt	geslagen	Overgeneralisation
eslagen	geslagen	Prefix ge without onset
slagen	geslagen	Lacking ge prefix
slaapte	sliep	Overgeneralisation
slaapten	sliepen	Overgeneralisation
sliepte	sliep	Irregular form plus regular suffix
sliepten	sliepen	Irregular form plus regular suffix
geslaapt	geslapen	Overgeneralisation
eslaapt	geslapen	Overgeneralisation
slaapt	geslapen	Overgeneralisation
seslaapt	geslapen	Overgeneralisation+prefix ge pronounced as se
geslaapte	geslapene	Overgeneralisation+
eslaapte	geslapene	Overgeneralisation+Prefix ge without onset
seslaapte	geslapene	Overgeneralisation+prefix ge pronounced as se
eslapen	geslapen	Prefix ge without onset
slapen	geslapen	Lacking ge prefix
slijpte	sleep	Overgeneralisation
slijpten	slepen	Overgeneralisation
sleepte	sleep	Irregular form plus regular suffix
sleepten	slepen	Irregular form plus regular suffix
geslijpt	geslepen	Overgeneralisation
eslijpt	geslepen	Overgeneralisation
slijpt	geslepen	Overgeneralisation
seslijpt	geslepen	Overgeneralisation+prefix ge pronounced as se
geslijpte	geslepene	Overgeneralisation+
eslijpte	geslepene	Overgeneralisation+Prefix ge without onset
seslijpte	geslepene	Overgeneralisation+prefix ge pronounced as se
geslijpen	geslepen	Wrong -en suffix
eslijpen	geslepen	Wrong -en suffix
slijpen	geslepen	Wrong -en suffix
gesleept	geslepen	Overgeneralisation
eslepen	geslepen	Prefix ge without onset
slepen	geslepen	Lacking ge prefix
slijtte	sleet	Overgeneralisation
slijtten	sleten	Overgeneralisation
sleette	sleet	Irregular form plus regular suffix
sleetten	sleten	Irregular form plus regular suffix
geslijt	gesleten	Overgeneralisation
eslijt	gesleten	Overgeneralisation
slijt	gesleten	Overgeneralisation
seslijt	gesleten	Overgeneralisation+prefix ge pronounced as se
geslijte	gesletene	Overgeneralisation+
eslijte	gesletene	Overgeneralisation+Prefix ge without onset
seslijte	gesletene	Overgeneralisation+prefix ge pronounced as se
geslijten	gesleten	Wrong -en suffix
eslijten	gesleten	Wrong -en suffix
slijten	gesleten	Wrong -en suffix
gesleet	gesleten	Overgeneralisation
esleten	gesleten	Prefix ge without onset
sleten	gesleten	Lacking ge prefix
slinkte	slonk	Overgeneralisation
slinkten	slonken	Overgeneralisation
slonkte	slonk	Irregular form plus regular suffix
slonkten	slonken	Irregular form plus regular suffix
geslinkt	Geslonken	Overgeneralisation
eslinkt	Geslonken	Overgeneralisation
slinkt	Geslonken	Overgeneralisation
seslinkt	Geslonken	Overgeneralisation+prefix ge pronounced as se
geslinkte	Geslonkene	Overgeneralisation+
eslinkte	Geslonkene	Overgeneralisation+Prefix ge without onset
seslinkte	Geslonkene	Overgeneralisation+prefix ge pronounced as se
geslinken	Geslonken	Wrong -en suffix
eslinken	Geslonken	Wrong -en suffix
slinken	Geslonken	Wrong -en suffix
geGeslonkt	Geslonken	Overgeneralisation
sluipte	sloop	Overgeneralisation
sluipten	slopen	Overgeneralisation
sloopte	sloop	Irregular form plus regular suffix
sloopten	slopen	Irregular form plus regular suffix
gesluipt	geslopen	Overgeneralisation
esluipt	geslopen	Overgeneralisation
sluipt	geslopen	Overgeneralisation
sesluipt	geslopen	Overgeneralisation+prefix ge pronounced as se
gesluipte	geslopene	Overgeneralisation+
esluipte	geslopene	Overgeneralisation+Prefix ge without onset
sesluipte	geslopene	Overgeneralisation+prefix ge pronounced as se
gesluipen	geslopen	Wrong -en suffix
esluipen	geslopen	Wrong -en suffix
sluipen	geslopen	Wrong -en suffix
gesloopt	geslopen	Overgeneralisation
eslopen	geslopen	Prefix ge without onset
slopen	geslopen	Lacking ge prefix
sluitte	sloot	Overgeneralisation
sluitten	sloten	Overgeneralisation
slootte	sloot	Irregular form plus regular suffix
slootten	sloten	Irregular form plus regular suffix
gesluit	gesloten	Overgeneralisation
esluit	gesloten	Overgeneralisation
sluit	gesloten	Overgeneralisation
sesluit	gesloten	Overgeneralisation+prefix ge pronounced as se
gesluite	geslotene	Overgeneralisation+
esluite	geslotene	Overgeneralisation+Prefix ge without onset
sesluite	geslotene	Overgeneralisation+prefix ge pronounced as se
gesluiten	gesloten	Wrong -en suffix
esluiten	gesloten	Wrong -en suffix
sluiten	gesloten	Wrong -en suffix
gesloot	gesloten	Overgeneralisation
esloten	gesloten	Prefix ge without onset
sloten	gesloten	Lacking ge prefix
smeltte	smolt	Overgeneralisation
smeltten	smolten	Overgeneralisation
smoltte	smolt	Irregular form plus regular suffix
smoltten	smolten	Irregular form plus regular suffix
gesmelt	gesmolten	Overgeneralisation
esmelt	gesmolten	Overgeneralisation
smelt	gesmolten	Overgeneralisation
sesmelt	gesmolten	Overgeneralisation+prefix ge pronounced as se
gesmelte	gesmoltene	Overgeneralisation+
esmelte	gesmoltene	Overgeneralisation+Prefix ge without onset
sesmelte	gesmoltene	Overgeneralisation+prefix ge pronounced as se
gesmelten	gesmolten	Wrong -en suffix
esmelten	gesmolten	Wrong -en suffix
smelten	gesmolten	Wrong -en suffix
gesmolt	gesmolten	Overgeneralisation
esmolten	gesmolten	Prefix ge without onset
smolten	gesmolten	Lacking ge prefix
smijtte	smeet	Overgeneralisation
smijtten	smeten	Overgeneralisation
smeette	smeet	Irregular form plus regular suffix
smeetten	smeten	Irregular form plus regular suffix
gesmijt	gesmeten	Overgeneralisation
esmijt	gesmeten	Overgeneralisation
smijt	gesmeten	Overgeneralisation
sesmijt	gesmeten	Overgeneralisation+prefix ge pronounced as se
gesmijte	gesmetene	Overgeneralisation+
esmijte	gesmetene	Overgeneralisation+Prefix ge without onset
sesmijte	gesmetene	Overgeneralisation+prefix ge pronounced as se
gesmijten	gesmeten	Wrong -en suffix
esmijten	gesmeten	Wrong -en suffix
smijten	gesmeten	Wrong -en suffix
gesmeet	gesmeten	Overgeneralisation
esmeten	gesmeten	Prefix ge without onset
smeten	gesmeten	Lacking ge prefix
snijdde	sneed	Overgeneralisation
snijdden	sneden	Overgeneralisation
sneedde	sneed	Irregular form plus regular suffix
sneedden	sneden	Irregular form plus regular suffix
gesnijd	gesneden	Overgeneralisation
esnijd	gesneden	Overgeneralisation
snijd	gesneden	Overgeneralisation
sesnijd	gesneden	Overgeneralisation+prefix ge pronounced as se
gesnijde	gesnedene	Overgeneralisation+
esnijde	gesnedene	Overgeneralisation+Prefix ge without onset
sesnijde	gesnedene	Overgeneralisation+prefix ge pronounced as se
gesnijden	gesneden	Wrong -en suffix
esnijden	gesneden	Wrong -en suffix
snijden	gesneden	Wrong -en suffix
gesneed	gesneden	Overgeneralisation
esneden	gesneden	Prefix ge without onset
sneden	gesneden	Lacking ge prefix
snuitte	snoot	Overgeneralisation
snuitten	snoten	Overgeneralisation
snootte	snoot	Irregular form plus regular suffix
snootten	snoten	Irregular form plus regular suffix
gesnuit	gesnoten	Overgeneralisation
esnuit	gesnoten	Overgeneralisation
snuit	gesnoten	Overgeneralisation
sesnuit	gesnoten	Overgeneralisation+prefix ge pronounced as se
gesnuite	gesnotene	Overgeneralisation+
esnuite	gesnotene	Overgeneralisation+Prefix ge without onset
sesnuite	gesnotene	Overgeneralisation+prefix ge pronounced as se
gesnuiten	gesnoten	Wrong -en suffix
esnuiten	gesnoten	Wrong -en suffix
snuiten	gesnoten	Wrong -en suffix
gesnoot	gesnoten	Overgeneralisation
esnoten	gesnoten	Prefix ge without onset
snoten	gesnoten	Lacking ge prefix
snuifde	snoof	Overgeneralisation
snuifden	snoven	Overgeneralisation
snoofde	snoof	Irregular form plus regular suffix
snoofden	snoven	Irregular form plus regular suffix
gesnuifd	gesnoven	Overgeneralisation+
esnuifd	gesnoven	Overgeneralisation+Prefix ge without onset
snuifd	gesnoven	Overgeneralisation+Lacking ge prefix
sesnuifd	gesnoven	Overgeneralisation+prefix ge pronounced as se
gesnuifde	gesnovene	Overgeneralisation+
esnuifde	gesnovene	Overgeneralisation+Prefix ge without onset
sesnuifde	gesnovene	Overgeneralisation+prefix ge pronounced as se
gesnuift	gesnoven	Overgeneralisation
esnuift	gesnoven	Overgeneralisation
snuift	gesnoven	Overgeneralisation
gesnuifen	gesnoven	Wrong -en suffix
esnuifen	gesnoven	Wrong -en suffix
snuifen	gesnoven	Wrong -en suffix
gesnooft	gesnoven	Overgeneralisation
esnoven	gesnoven	Prefix ge without onset
snoven	gesnoven	Lacking ge prefix
gespand	gespannen	Overgeneralisation
espand	gespannen	Overgeneralisation+Prefix ge without onset
spand	gespannen	Overgeneralisation+Lacking ge prefix
sespand	gespannen	Overgeneralisation+prefix ge pronounced as se
gespande	gespannene	Overgeneralisation+
espande	gespannene	Overgeneralisation+Prefix ge without onset
sespande	gespannene	Overgeneralisation+prefix ge pronounced as se
gespant	gespannen	Overgeneralisation
espant	gespannen	Overgeneralisation
spant	gespannen	Overgeneralisation
espannen	gespannen	Prefix ge without onset
spannen	gespannen	Lacking ge prefix
spijtte	speet	Overgeneralisation
spijtten	speten	Overgeneralisation
speette	speet	Irregular form plus regular suffix
speetten	speten	Irregular form plus regular suffix
gespijt	gespeten	Overgeneralisation
espijt	gespeten	Overgeneralisation
spijt	gespeten	Overgeneralisation
sespijt	gespeten	Overgeneralisation+prefix ge pronounced as se
gespijte	gespetene	Overgeneralisation+
espijte	gespetene	Overgeneralisation+Prefix ge without onset
sespijte	gespetene	Overgeneralisation+prefix ge pronounced as se
gespijten	gespeten	Wrong -en suffix
espijten	gespeten	Wrong -en suffix
spijten	gespeten	Wrong -en suffix
gespeet	gespeten	Overgeneralisation
espeten	gespeten	Prefix ge without onset
speten	gespeten	Lacking ge prefix
spinde	spon	Overgeneralisation
spinden	sponnen	Overgeneralisation
sponde	spon	Irregular form plus regular suffix
sponden	sponnen	Irregular form plus regular suffix
gespind	gesponnen	Overgeneralisation+
espind	gesponnen	Overgeneralisation+Prefix ge without onset
spind	gesponnen	Overgeneralisation+Lacking ge prefix
sespind	gesponnen	Overgeneralisation+prefix ge pronounced as se
gespinde	gesponnene	Overgeneralisation+
espinde	gesponnene	Overgeneralisation+Prefix ge without onset
sespinde	gesponnene	Overgeneralisation+prefix ge pronounced as se
gespint	gesponnen	Overgeneralisation
espint	gesponnen	Overgeneralisation
spint	gesponnen	Overgeneralisation
gespinnen	gesponnen	Wrong -en suffix
espinnen	gesponnen	Wrong -en suffix
spinnen	gesponnen	Wrong -en suffix
gespont	gesponnen	Overgeneralisation
esponnen	gesponnen	Prefix ge without onset
sponnen	gesponnen	Lacking ge prefix
splijtte	spleet	Overgeneralisation
splijtten	spleten	Overgeneralisation
spleette	spleet	Irregular form plus regular suffix
spleetten	spleten	Irregular form plus regular suffix
gesplijt	gespleten	Overgeneralisation
esplijt	gespleten	Overgeneralisation
splijt	gespleten	Overgeneralisation
sesplijt	gespleten	Overgeneralisation+prefix ge pronounced as se
gesplijte	gespletene	Overgeneralisation+
esplijte	gespletene	Overgeneralisation+Prefix ge without onset
sesplijte	gespletene	Overgeneralisation+prefix ge pronounced as se
gesplijten	gespleten	Wrong -en suffix
esplijten	gespleten	Wrong -en suffix
splijten	gespleten	Wrong -en suffix
gespleet	gespleten	Overgeneralisation
espleten	gespleten	Prefix ge without onset
spleten	gespleten	Lacking ge prefix
spreekte	sprak	Overgeneralisation
spreekten	spraken	Overgeneralisation
sprakte	sprak	Irregular form plus regular suffix
sprakten	spraken	Irregular form plus regular suffix
gespreekt	gesproken	Overgeneralisation
espreekt	gesproken	Overgeneralisation
spreekt	gesproken	Overgeneralisation
sespreekt	gesproken	Overgeneralisation+prefix ge pronounced as se
gespreekte	gesprokene	Overgeneralisation+
espreekte	gesprokene	Overgeneralisation+Prefix ge without onset
sespreekte	gesprokene	Overgeneralisation+prefix ge pronounced as se
gespreken	gesproken	Wrong -en suffix
espreken	gesproken	Wrong -en suffix
spreken	gesproken	Wrong -en suffix
gesprookt	gesproken	Overgeneralisation
esproken	gesproken	Prefix ge without onset
sproken	gesproken	Lacking ge prefix
springde	sprong	Overgeneralisation
springden	sprongen	Overgeneralisation
sprongde	sprong	Irregular form plus regular suffix
sprongden	sprongen	Irregular form plus regular suffix
gespringd	gesprongen	Overgeneralisation+
espringd	gesprongen	Overgeneralisation+Prefix ge without onset
springd	gesprongen	Overgeneralisation+Lacking ge prefix
sespringd	gesprongen	Overgeneralisation+prefix ge pronounced as se
gespringde	gesprongene	Overgeneralisation+
espringde	gesprongene	Overgeneralisation+Prefix ge without onset
sespringde	gesprongene	Overgeneralisation+prefix ge pronounced as se
gespringt	gesprongen	Overgeneralisation
espringt	gesprongen	Overgeneralisation
springt	gesprongen	Overgeneralisation
gespringen	gesprongen	Wrong -en suffix
espringen	gesprongen	Wrong -en suffix
springen	gesprongen	Wrong -en suffix
gesprongd	gesprongen	Overgeneralisation
gesprongt	gesprongen	Overgeneralisation
esprongen	gesprongen	Prefix ge without onset
sprongen	gesprongen	Lacking ge prefix
spruitte	sproot	Overgeneralisation
spruitten	sproten	Overgeneralisation
sprootte	sproot	Irregular form plus regular suffix
sprootten	sproten	Irregular form plus regular suffix
gespruit	gesproten	Overgeneralisation
espruit	gesproten	Overgeneralisation
spruit	gesproten	Overgeneralisation
sespruit	gesproten	Overgeneralisation+prefix ge pronounced as se
gespruite	gesprotene	Overgeneralisation+
espruite	gesprotene	Overgeneralisation+Prefix ge without onset
sespruite	gesprotene	Overgeneralisation+prefix ge pronounced as se
gespruiten	gesproten	Wrong -en suffix
espruiten	gesproten	Wrong -en suffix
spruiten	gesproten	Wrong -en suffix
gesproot	gesproten	Overgeneralisation
esproten	gesproten	Prefix ge without onset
sproten	gesproten	Lacking ge prefix
spuitte	spoot	Overgeneralisation
spuitten	spoten	Overgeneralisation
spootte	spoot	Irregular form plus regular suffix
spootten	spoten	Irregular form plus regular suffix
gespuit	gespoten	Overgeneralisation
espuit	gespoten	Overgeneralisation
spuit	gespoten	Overgeneralisation
sespuit	gespoten	Overgeneralisation+prefix ge pronounced as se
gespuite	gespotene	Overgeneralisation+
espuite	gespotene	Overgeneralisation+Prefix ge without onset
sespuite	gespotene	Overgeneralisation+prefix ge pronounced as se
gespuiten	gespoten	Wrong -en suffix
espuiten	gespoten	Wrong -en suffix
spuiten	gespoten	Wrong -en suffix
gespoot	gespoten	Overgeneralisation
espoten	gespoten	Prefix ge without onset
spoten	gespoten	Lacking ge prefix
state	stond	Overgeneralisation
staten	stonden	Overgeneralisation
stondte	stond	Irregular form plus regular suffix
stondten	stonden	Irregular form plus regular suffix
gestat	gestaan	Overgeneralisation+
estat	gestaan	Overgeneralisation+Prefix ge without onset
stat	gestaan	Overgeneralisation+Lacking ge prefix
sestat	gestaan	Overgeneralisation+prefix ge pronounced as se
gestatte	gestaane	Overgeneralisation+
estatte	gestaane	Overgeneralisation+Prefix ge without onset
sestatte	gestaane	Overgeneralisation+prefix ge pronounced as se
gestaat	gestaan	Overgeneralisation
estaat	gestaan	Overgeneralisation
staat	gestaan	Overgeneralisation
estaan	gestaan	Prefix ge without onset
staan	gestaan	Lacking ge prefix
steekte	stak	Overgeneralisation
steekten	staken	Overgeneralisation
stakte	stak	Irregular form plus regular suffix
stakten	staken	Irregular form plus regular suffix
gesteekt	gestoken	Overgeneralisation
esteekt	gestoken	Overgeneralisation
steekt	gestoken	Overgeneralisation
sesteekt	gestoken	Overgeneralisation+prefix ge pronounced as se
gesteekte	gestokene	Overgeneralisation+
esteekte	gestokene	Overgeneralisation+Prefix ge without onset
sesteekte	gestokene	Overgeneralisation+prefix ge pronounced as se
gesteken	gestoken	Wrong -en suffix
esteken	gestoken	Wrong -en suffix
steken	gestoken	Wrong -en suffix
gestookt	gestoken	Overgeneralisation
estoken	gestoken	Prefix ge without onset
stoken	gestoken	Lacking ge prefix
steelde	stal	Overgeneralisation
steelden	stalen	Overgeneralisation
stalde	stal	Irregular form plus regular suffix
stalden	stalen	Irregular form plus regular suffix
gesteeld	gestolen	Overgeneralisation+
esteeld	gestolen	Overgeneralisation+Prefix ge without onset
steeld	gestolen	Overgeneralisation+Lacking ge prefix
sesteeld	gestolen	Overgeneralisation+prefix ge pronounced as se
gesteelde	gestolene	Overgeneralisation+
esteelde	gestolene	Overgeneralisation+Prefix ge without onset
sesteelde	gestolene	Overgeneralisation+prefix ge pronounced as se
gesteelt	gestolen	Overgeneralisation
esteelt	gestolen	Overgeneralisation
steelt	gestolen	Overgeneralisation
gestelen	gestolen	Wrong -en suffix
estelen	gestolen	Wrong -en suffix
stelen	gestolen	Wrong -en suffix
gestoolt	gestolen	Overgeneralisation
estolen	gestolen	Prefix ge without onset
stolen	gestolen	Lacking ge prefix
sterfde	stierf	Overgeneralisation
sterfden	stierven	Overgeneralisation
stierfde	stierf	Irregular form plus regular suffix
stierfden	stierven	Irregular form plus regular suffix
gesterfd	gestorven	Overgeneralisation+
esterfd	gestorven	Overgeneralisation+Prefix ge without onset
sterfd	gestorven	Overgeneralisation+Lacking ge prefix
sesterfd	gestorven	Overgeneralisation+prefix ge pronounced as se
gesterfde	gestorvene	Overgeneralisation+
esterfde	gestorvene	Overgeneralisation+Prefix ge without onset
sesterfde	gestorvene	Overgeneralisation+prefix ge pronounced as se
gesterft	gestorven	Overgeneralisation
esterft	gestorven	Overgeneralisation
sterft	gestorven	Overgeneralisation
gesterfen	gestorven	Wrong -en suffix
esterfen	gestorven	Wrong -en suffix
sterfen	gestorven	Wrong -en suffix
gestorfd	gestorven	Overgeneralisation
gestorft	gestorven	Overgeneralisation
estorven	gestorven	Prefix ge without onset
storven	gestorven	Lacking ge prefix
stijgde	steeg	Overgeneralisation
stijgden	stegen	Overgeneralisation
steegde	steeg	Irregular form plus regular suffix
steegden	stegen	Irregular form plus regular suffix
gestijgd	gestegen	Overgeneralisation+
estijgd	gestegen	Overgeneralisation+Prefix ge without onset
stijgd	gestegen	Overgeneralisation+Lacking ge prefix
sestijgd	gestegen	Overgeneralisation+prefix ge pronounced as se
gestijgde	gestegene	Overgeneralisation+
estijgde	gestegene	Overgeneralisation+Prefix ge without onset
sestijgde	gestegene	Overgeneralisation+prefix ge pronounced as se
gestijgt	gestegen	Overgeneralisation
estijgt	gestegen	Overgeneralisation
stijgt	gestegen	Overgeneralisation
gestijgen	gestegen	Wrong -en suffix
estijgen	gestegen	Wrong -en suffix
stijgen	gestegen	Wrong -en suffix
gesteegd	gestegen	Overgeneralisation
gesteegt	gestegen	Overgeneralisation
estegen	gestegen	Prefix ge without onset
stegen	gestegen	Lacking ge prefix
stijfde	steef	Overgeneralisation
stijfden	steven	Overgeneralisation
steefde	steef	Irregular form plus regular suffix
steefden	steven	Irregular form plus regular suffix
gestijfd	gesteven	Overgeneralisation+
estijfd	gesteven	Overgeneralisation+Prefix ge without onset
stijfd	gesteven	Overgeneralisation+Lacking ge prefix
sestijfd	gesteven	Overgeneralisation+prefix ge pronounced as se
gestijfde	gestevene	Overgeneralisation+
estijfde	gestevene	Overgeneralisation+Prefix ge without onset
sestijfde	gestevene	Overgeneralisation+prefix ge pronounced as se
gestijft	gesteven	Overgeneralisation
estijft	gesteven	Overgeneralisation
stijft	gesteven	Overgeneralisation
gestijfen	gesteven	Wrong -en suffix
estijfen	gesteven	Wrong -en suffix
stijfen	gesteven	Wrong -en suffix
gesteefd	gesteven	Overgeneralisation
gesteeft	gesteven	Overgeneralisation
esteven	gesteven	Prefix ge without onset
steven	gesteven	Lacking ge prefix
stinkte	stonk	Overgeneralisation
stinkten	stonken	Overgeneralisation
stonkte	stonk	Irregular form plus regular suffix
stonkten	stonken	Irregular form plus regular suffix
gestinkt	gestonken	Overgeneralisation
estinkt	gestonken	Overgeneralisation
stinkt	gestonken	Overgeneralisation
sestinkt	gestonken	Overgeneralisation+prefix ge pronounced as se
gestinkte	gestonkene	Overgeneralisation+
estinkte	gestonkene	Overgeneralisation+Prefix ge without onset
sestinkte	gestonkene	Overgeneralisation+prefix ge pronounced as se
gestinken	gestonken	Wrong -en suffix
estinken	gestonken	Wrong -en suffix
stinken	gestonken	Wrong -en suffix
gestonkt	gestonken	Overgeneralisation
estonken	gestonken	Prefix ge without onset
stonken	gestonken	Lacking ge prefix
gestoot	gestoten	Overgeneralisation
estoot	gestoten	Overgeneralisation
stoot	gestoten	Overgeneralisation
sestoot	gestoten	Overgeneralisation+prefix ge pronounced as se
gestote	gestotene	Overgeneralisation+
estote	gestotene	Overgeneralisation+Prefix ge without onset
sestote	gestotene	Overgeneralisation+prefix ge pronounced as se
estoten	gestoten	Prefix ge without onset
stoten	gestoten	Lacking ge prefix
strijdde	streed	Overgeneralisation
strijdden	streden	Overgeneralisation
streedde	streed	Irregular form plus regular suffix
streedden	streden	Irregular form plus regular suffix
gestrijd	gestreden	Overgeneralisation
estrijd	gestreden	Overgeneralisation
strijd	gestreden	Overgeneralisation
sestrijd	gestreden	Overgeneralisation+prefix ge pronounced as se
gestrijde	gestredene	Overgeneralisation+
estrijde	gestredene	Overgeneralisation+Prefix ge without onset
sestrijde	gestredene	Overgeneralisation+prefix ge pronounced as se
gestrijden	gestreden	Wrong -en suffix
estrijden	gestreden	Wrong -en suffix
strijden	gestreden	Wrong -en suffix
gestreed	gestreden	Overgeneralisation
estreden	gestreden	Prefix ge without onset
streden	gestreden	Lacking ge prefix
strijkte	streek	Overgeneralisation
strijkten	streken	Overgeneralisation
streekte	streek	Irregular form plus regular suffix
streekten	streken	Irregular form plus regular suffix
gestrijkt	gestreken	Overgeneralisation
estrijkt	gestreken	Overgeneralisation
strijkt	gestreken	Overgeneralisation
sestrijkt	gestreken	Overgeneralisation+prefix ge pronounced as se
gestrijkte	gestrekene	Overgeneralisation+
estrijkte	gestrekene	Overgeneralisation+Prefix ge without onset
sestrijkte	gestrekene	Overgeneralisation+prefix ge pronounced as se
gestrijken	gestreken	Wrong -en suffix
estrijken	gestreken	Wrong -en suffix
strijken	gestreken	Wrong -en suffix
gestreekt	gestreken	Overgeneralisation
estreken	gestreken	Prefix ge without onset
streken	gestreken	Lacking ge prefix
stuifde	stoof	Overgeneralisation
stuifden	stoven	Overgeneralisation
stoofde	stoof	Irregular form plus regular suffix
stoofden	stoven	Irregular form plus regular suffix
gestuifd	gestoventoven	Overgeneralisation+
estuifd	gestoventoven	Overgeneralisation+Prefix ge without onset
stuifd	gestoventoven	Overgeneralisation+Lacking ge prefix
sestuifd	gestoventoven	Overgeneralisation+prefix ge pronounced as se
gestuifde	gestoventovene	Overgeneralisation+
estuifde	gestoventovene	Overgeneralisation+Prefix ge without onset
sestuifde	gestoventovene	Overgeneralisation+prefix ge pronounced as se
gestuift	gestoventoven	Overgeneralisation
estuift	gestoventoven	Overgeneralisation
stuift	gestoventoven	Overgeneralisation
gestuifen	gestoventoven	Wrong -en suffix
estuifen	gestoventoven	Wrong -en suffix
stuifen	gestoventoven	Wrong -en suffix
gestoventooft	gestoventoven	Overgeneralisation
estoventoven	gestoventoven	Prefix ge without onset
stoventoven	gestoventoven	Lacking ge prefix
treedde	trad	Overgeneralisation
treedden	traden	Overgeneralisation
tradde	trad	Irregular form plus regular suffix
tradden	traden	Irregular form plus regular suffix
getreed	getreden	Overgeneralisation
etreed	getreden	Overgeneralisation
treed	getreden	Overgeneralisation
setreed	getreden	Overgeneralisation+prefix ge pronounced as se
getrede	getredene	Overgeneralisation+
etrede	getredene	Overgeneralisation+Prefix ge without onset
setrede	getredene	Overgeneralisation+prefix ge pronounced as se
etreden	getreden	Prefix ge without onset
treden	getreden	Lacking ge prefix
trefte	trof	Overgeneralisation
treften	troffen	Overgeneralisation
trofte	trof	Irregular form plus regular suffix
troften	troffen	Irregular form plus regular suffix
getreft	getroffen	Overgeneralisation
etreft	getroffen	Overgeneralisation
treft	getroffen	Overgeneralisation
setreft	getroffen	Overgeneralisation+prefix ge pronounced as se
getrefte	getroffene	Overgeneralisation+
etrefte	getroffene	Overgeneralisation+Prefix ge without onset
setrefte	getroffene	Overgeneralisation+prefix ge pronounced as se
getreffen	getroffen	Wrong -en suffix
etreffen	getroffen	Wrong -en suffix
treffen	getroffen	Wrong -en suffix
getroft	getroffen	Overgeneralisation
etroffen	getroffen	Prefix ge without onset
troffen	getroffen	Lacking ge prefix
trekte	trok	Overgeneralisation
trekten	trokken	Overgeneralisation
trokte	trok	Irregular form plus regular suffix
trokten	trokken	Irregular form plus regular suffix
getrekt	getrokken	Overgeneralisation
etrekt	getrokken	Overgeneralisation
trekt	getrokken	Overgeneralisation
setrekt	getrokken	Overgeneralisation+prefix ge pronounced as se
getrekte	getrokkene	Overgeneralisation+
etrekte	getrokkene	Overgeneralisation+Prefix ge without onset
setrekte	getrokkene	Overgeneralisation+prefix ge pronounced as se
getrekken	getrokken	Wrong -en suffix
etrekken	getrokken	Wrong -en suffix
trekken	getrokken	Wrong -en suffix
getrokt	getrokken	Overgeneralisation
etrokken	getrokken	Prefix ge without onset
trokken	getrokken	Lacking ge prefix
valde	viel	Overgeneralisation
valden	vielen	Overgeneralisation
vielde	viel	Irregular form plus regular suffix
vielden	vielen	Irregular form plus regular suffix
gevald	gevallen	Overgeneralisation
evald	gevallen	Overgeneralisation+Prefix ge without onset
vald	gevallen	Overgeneralisation+Lacking ge prefix
sevald	gevallen	Overgeneralisation+prefix ge pronounced as se
gevalde	gevallene	Overgeneralisation+
evalde	gevallene	Overgeneralisation+Prefix ge without onset
sevalde	gevallene	Overgeneralisation+prefix ge pronounced as se
gevalt	gevallen	Overgeneralisation
evalt	gevallen	Overgeneralisation
valt	gevallen	Overgeneralisation
evallen	gevallen	Prefix ge without onset
vallen	gevallen	Lacking ge prefix
vangde	ving	Overgeneralisation
vangden	vingen	Overgeneralisation
vingde	ving	Irregular form plus regular suffix
vingden	vingen	Irregular form plus regular suffix
gevangd	gevangen	Overgeneralisation
evangd	gevangen	Overgeneralisation+Prefix ge without onset
vangd	gevangen	Overgeneralisation+Lacking ge prefix
sevangd	gevangen	Overgeneralisation+prefix ge pronounced as se
gevangde	gevangene	Overgeneralisation+
evangde	gevangene	Overgeneralisation+Prefix ge without onset
sevangde	gevangene	Overgeneralisation+prefix ge pronounced as se
gevangt	gevangen	Overgeneralisation
evangt	gevangen	Overgeneralisation
vangt	gevangen	Overgeneralisation
evangen	gevangen	Prefix ge without onset
vangen	gevangen	Lacking ge prefix
vaarde	voer	Overgeneralisation
vaarden	voeren	Overgeneralisation
voerde	voer	Irregular form plus regular suffix
voerden	voeren	Irregular form plus regular suffix
gevaard	gevaren	Overgeneralisation
evaard	gevaren	Overgeneralisation+Prefix ge without onset
vaard	gevaren	Overgeneralisation+Lacking ge prefix
sevaard	gevaren	Overgeneralisation+prefix ge pronounced as se
gevaarde	gevarene	Overgeneralisation+
evaarde	gevarene	Overgeneralisation+Prefix ge without onset
sevaarde	gevarene	Overgeneralisation+prefix ge pronounced as se
gevaart	gevaren	Overgeneralisation
evaart	gevaren	Overgeneralisation
vaart	gevaren	Overgeneralisation
evaren	gevaren	Prefix ge without onset
varen	gevaren	Lacking ge prefix
vechtte	vocht	Overgeneralisation
vechtten	vochten	Overgeneralisation
vochtte	vocht	Irregular form plus regular suffix
vochtten	vochten	Irregular form plus regular suffix
gevecht	gevochten	Overgeneralisation
evecht	gevochten	Overgeneralisation
vecht	gevochten	Overgeneralisation
sevecht	gevochten	Overgeneralisation+prefix ge pronounced as se
gevechte	gevochtene	Overgeneralisation+
evechte	gevochtene	Overgeneralisation+Prefix ge without onset
sevechte	gevochtene	Overgeneralisation+prefix ge pronounced as se
gevechten	gevochten	Wrong -en suffix
evechten	gevochten	Wrong -en suffix
vechten	gevochten	Wrong -en suffix
gevocht	gevochten	Overgeneralisation
evochten	gevochten	Prefix ge without onset
vochten	gevochten	Lacking ge prefix
verdriette	verdroot	Overgeneralisation
verdrietten	verdroten	Overgeneralisation
verdrootte	verdroot	Irregular form plus regular suffix
verdrootten	verdroten	Irregular form plus regular suffix
verdriet	verdroten	Overgeneralisation
verdriete	verdrotene	Overgeneralisation
verdrieten	verdroten	Wrong -en suffix
verdroot	verdroten	Overgeneralisation
verdwijnde	verdwenene	Overgeneralisation
verdwijnden	verdwenen	Overgeneralisation
verdweende	verdween	Irregular form plus regular suffix
verdweenden	verdwenen	Irregular form plus regular suffix
verdwijnd	verdwenen	Overgeneralisation
verdwijnt	verdwenen	Overgeneralisation
verdwijnen	verdwenen	Wrong -en suffix
verdweend	verdwenen	Overgeneralisation
verdweent	verdwenen	Overgeneralisation
vergeette	vergat	Overgeneralisation
vergeetten	vergaten	Overgeneralisation
vergatte	vergat	Irregular form plus regular suffix
vergatten	vergaten	Irregular form plus regular suffix
vergeet	vergeten	Overgeneralisation
vergete	vergetene	Overgeneralisation
verliesde	verlorene	Overgeneralisation
verliesden	verloren	Overgeneralisation
verloorde	verloor	Irregular form plus regular suffix
verloorden	verloren	Irregular form plus regular suffix
verliesd	verloren	Overgeneralisation
verliest	verloren	Overgeneralisation
verliesen	verloren	Wrong -en suffix
verloort	verloren	Overgeneralisation
vindde	vond	Overgeneralisation
vindden	vonden	Overgeneralisation
vondde	vond	Irregular form plus regular suffix
vondden	vonden	Irregular form plus regular suffix
gevind	gevonden	Overgeneralisation
evind	gevonden	Overgeneralisation
vind	gevonden	Overgeneralisation
sevind	gevonden	Overgeneralisation+prefix ge pronounced as se
gevinde	gevondene	Overgeneralisation+
evinde	gevondene	Overgeneralisation+Prefix ge without onset
sevinde	gevondene	Overgeneralisation+prefix ge pronounced as se
gevinden	gevonden	Wrong -en suffix
evinden	gevonden	Wrong -en suffix
vinden	gevonden	Wrong -en suffix
gevond	gevonden	Overgeneralisation
evonden	gevonden	Prefix ge without onset
vonden	gevonden	Lacking ge prefix
vlechtte	vlocht	Overgeneralisation
vlechtten	vlochten	Overgeneralisation
vlochtte	vlocht	Irregular form plus regular suffix
vlochtten	vlochten	Irregular form plus regular suffix
gevlecht	gevlochten	Overgeneralisation
evlecht	gevlochten	Overgeneralisation
vlecht	gevlochten	Overgeneralisation
sevlecht	gevlochten	Overgeneralisation+prefix ge pronounced as se
gevlechte	gevlochtene	Overgeneralisation+
evlechte	gevlochtene	Overgeneralisation+Prefix ge without onset
sevlechte	gevlochtene	Overgeneralisation+prefix ge pronounced as se
gevlechten	gevlochten	Wrong -en suffix
evlechten	gevlochten	Wrong -en suffix
vlechten	gevlochten	Wrong -en suffix
gevlocht	gevlochten	Overgeneralisation
evlochten	gevlochten	Prefix ge without onset
vlochten	gevlochten	Lacking ge prefix
vliegde	vloog	Overgeneralisation
vliegden	vlogen	Overgeneralisation
vloogde	vloog	Irregular form plus regular suffix
vloogden	vlogen	Irregular form plus regular suffix
gevliegd	gevlogen	Overgeneralisation+
evliegd	gevlogen	Overgeneralisation+Prefix ge without onset
vliegd	gevlogen	Overgeneralisation+Lacking ge prefix
sevliegd	gevlogen	Overgeneralisation+prefix ge pronounced as se
gevliegde	gevlogene	Overgeneralisation+
evliegde	gevlogene	Overgeneralisation+Prefix ge without onset
sevliegde	gevlogene	Overgeneralisation+prefix ge pronounced as se
gevliegt	gevlogen	Overgeneralisation
evliegt	gevlogen	Overgeneralisation
vliegt	gevlogen	Overgeneralisation
gevliegen	gevlogen	Wrong -en suffix
evliegen	gevlogen	Wrong -en suffix
vliegen	gevlogen	Wrong -en suffix
gevloogt	gevlogen	Overgeneralisation
evlogen	gevlogen	Prefix ge without onset
vlogen	gevlogen	Lacking ge prefix
gevouwd	gevouwen	Overgeneralisation
evouwd	gevouwen	Overgeneralisation+Prefix ge without onset
vouwd	gevouwen	Overgeneralisation+Lacking ge prefix
sevouwd	gevouwen	Overgeneralisation+prefix ge pronounced as se
gevouwde	gevouwene	Overgeneralisation+
evouwde	gevouwene	Overgeneralisation+Prefix ge without onset
sevouwde	gevouwene	Overgeneralisation+prefix ge pronounced as se
gevouwt	gevouwen	Overgeneralisation
evouwt	gevouwen	Overgeneralisation
vouwt	gevouwen	Overgeneralisation
evouwen	gevouwen	Prefix ge without onset
vouwen	gevouwen	Lacking ge prefix
vraagde	vroeg	Overgeneralisation
vraagden	vroegen	Overgeneralisation
vroegde	vroeg	Irregular form plus regular suffix
vroegden	vroegen	Irregular form plus regular suffix
evraagd	gevraagd	Prefix ge without onset
vraagd	gevraagd	Lacking ge prefix
sevraagd	gevraagd	Overgeneralisation+prefix ge pronounced as se
evraagde	gevraagde	Overgeneralisation+Prefix ge without onset
sevraagde	gevraagde	Overgeneralisation+prefix ge pronounced as se
gevraagt	gevraagd	Overgeneralisation
evraagt	gevraagd	Overgeneralisation
vraagt	gevraagd	Overgeneralisation
gevragen	gevraagd	Wrong -en suffix
evragen	gevraagd	Wrong -en suffix
vragen	gevraagd	Wrong -en suffix
vreette	vrat	Overgeneralisation
vreetten	vraten	Overgeneralisation
vratte	vrat	Irregular form plus regular suffix
vratten	vraten	Irregular form plus regular suffix
gevreet	gevreten	Overgeneralisation
evreet	gevreten	Overgeneralisation
vreet	gevreten	Overgeneralisation
sevreet	gevreten	Overgeneralisation+prefix ge pronounced as se
gevrete	gevretene	Overgeneralisation+
evrete	gevretene	Overgeneralisation+Prefix ge without onset
sevrete	gevretene	Overgeneralisation+prefix ge pronounced as se
evreten	gevreten	Prefix ge without onset
vreten	gevreten	Lacking ge prefix
vriesde	vroor	Overgeneralisation
vriesden	vroren	Overgeneralisation
vroorde	vroor	Irregular form plus regular suffix
vroorden	vroren	Irregular form plus regular suffix
gevriesd	gevroren	Overgeneralisation+
evriesd	gevroren	Overgeneralisation+Prefix ge without onset
vriesd	gevroren	Overgeneralisation+Lacking ge prefix
sevriesd	gevroren	Overgeneralisation+prefix ge pronounced as se
gevriesde	gevrorene	Overgeneralisation+
evriesde	gevrorene	Overgeneralisation+Prefix ge without onset
sevriesde	gevrorene	Overgeneralisation+prefix ge pronounced as se
gevriest	gevroren	Overgeneralisation
evriest	gevroren	Overgeneralisation
vriest	gevroren	Overgeneralisation
gevriesen	gevroren	Wrong -en suffix
evriesen	gevroren	Wrong -en suffix
vriesen	gevroren	Wrong -en suffix
gevroort	gevroren	Overgeneralisation
evroren	gevroren	Prefix ge without onset
vroren	gevroren	Lacking ge prefix
vriijde	vrijde	Overgeneralisation
vriijden	vrijden	Overgeneralisation
gevriijd	gevrijd	Overgeneralisation+
evriijd	gevrijd	Overgeneralisation+Prefix ge without onset
vriijd	gevrijd	Overgeneralisation+Lacking ge prefix
sevriijd	gevrijd	Overgeneralisation+prefix ge pronounced as se
gevriijde	gevrijde	Overgeneralisation+
evriijde	gevrijde	Overgeneralisation+Prefix ge without onset
sevriijde	gevrijde	Overgeneralisation+prefix ge pronounced as se
gevriijt	gevrijd	Overgeneralisation
evriijt	gevrijd	Overgeneralisation
vriijt	gevrijd	Overgeneralisation
gevrijen	gevrijd	Wrong -en suffix
evrijen	gevrijd	Wrong -en suffix
vrijen	gevrijd	Wrong -en suffix
evrijd	gevrijd	Prefix ge without onset
vrijd	gevrijd	Lacking ge prefix
gewast	gewassen	Overgeneralisation
ewast	gewassen	Overgeneralisation
wast	gewassen	Overgeneralisation
sewast	gewassen	Overgeneralisation+prefix ge pronounced as se
gewaste	gewassene	Overgeneralisation+
ewaste	gewassene	Overgeneralisation+Prefix ge without onset
sewaste	gewassene	Overgeneralisation+prefix ge pronounced as se
ewassen	gewassen	Prefix ge without onset
wassen	gewassen	Lacking ge prefix
weegde	woog	Overgeneralisation
weegden	wogen	Overgeneralisation
woogde	woog	Irregular form plus regular suffix
woogden	wogen	Irregular form plus regular suffix
geweegd	gewogen	Overgeneralisation+
eweegd	gewogen	Overgeneralisation+Prefix ge without onset
weegd	gewogen	Overgeneralisation+Lacking ge prefix
seweegd	gewogen	Overgeneralisation+prefix ge pronounced as se
geweegde	gewogene	Overgeneralisation+
eweegde	gewogene	Overgeneralisation+Prefix ge without onset
seweegde	gewogene	Overgeneralisation+prefix ge pronounced as se
geweegt	gewogen	Overgeneralisation
eweegt	gewogen	Overgeneralisation
weegt	gewogen	Overgeneralisation
gewegen	gewogen	Wrong -en suffix
ewegen	gewogen	Wrong -en suffix
wegen	gewogen	Wrong -en suffix
gewoogt	gewogen	Overgeneralisation
ewogen	gewogen	Prefix ge without onset
wogen	gewogen	Lacking ge prefix
werpte	wierp	Overgeneralisation
werpten	wierpen	Overgeneralisation
wierpte	wierp	Irregular form plus regular suffix
wierpten	wierpen	Irregular form plus regular suffix
gewerpt	geworpen	Overgeneralisation
ewerpt	geworpen	Overgeneralisation
werpt	geworpen	Overgeneralisation
sewerpt	geworpen	Overgeneralisation+prefix ge pronounced as se
gewerpte	geworpene	Overgeneralisation+
ewerpte	geworpene	Overgeneralisation+Prefix ge without onset
sewerpte	geworpene	Overgeneralisation+prefix ge pronounced as se
gewerpen	geworpen	Wrong -en suffix
ewerpen	geworpen	Wrong -en suffix
werpen	geworpen	Wrong -en suffix
geworpt	geworpen	Overgeneralisation
eworpen	geworpen	Prefix ge without onset
worpen	geworpen	Lacking ge prefix
werfde	wierf	Overgeneralisation
werfden	wierven	Overgeneralisation
wierfde	wierf	Irregular form plus regular suffix
wierfden	wierven	Irregular form plus regular suffix
gewerfd	geworven	Overgeneralisation+
ewerfd	geworven	Overgeneralisation+Prefix ge without onset
werfd	geworven	Overgeneralisation+Lacking ge prefix
sewerfd	geworven	Overgeneralisation+prefix ge pronounced as se
gewerfde	geworvene	Overgeneralisation+
ewerfde	geworvene	Overgeneralisation+Prefix ge without onset
sewerfde	geworvene	Overgeneralisation+prefix ge pronounced as se
gewerft	geworven	Overgeneralisation
ewerft	geworven	Overgeneralisation
werft	geworven	Overgeneralisation
gewerfen	geworven	Wrong -en suffix
ewerfen	geworven	Wrong -en suffix
werfen	geworven	Wrong -en suffix
geworfd	geworven	Overgeneralisation
geworft	geworven	Overgeneralisation
eworven	geworven	Prefix ge without onset
worven	geworven	Lacking ge prefix
weette	weet	Irregular form plus regular suffix
weetten	weten	Irregular form plus regular suffix
wistte	wist	Irregular form plus regular suffix
wistten	wisten	Irregular form plus regular suffix
geweet	geweten	Overgeneralisation
eweet	geweten	Overgeneralisation
weet	geweten	Overgeneralisation
seweet	geweten	Overgeneralisation+prefix ge pronounced as se
gewete	gewetene	Overgeneralisation+
ewete	gewetene	Overgeneralisation+Prefix ge without onset
sewete	gewetene	Overgeneralisation+prefix ge pronounced as se
eweten	geweten	Prefix ge without onset
weten	geweten	Lacking ge prefix
geweefd	geweven	Overgeneralisation
eweefd	geweven	Overgeneralisation+Prefix ge without onset
weefd	geweven	Overgeneralisation+Lacking ge prefix
seweefd	geweven	Overgeneralisation+prefix ge pronounced as se
geweefde	gewevene	Overgeneralisation+
eweefde	gewevene	Overgeneralisation+Prefix ge without onset
seweefde	gewevene	Overgeneralisation+prefix ge pronounced as se
geweeft	geweven	Overgeneralisation
eweeft	geweven	Overgeneralisation
weeft	geweven	Overgeneralisation
gewefen	geweven	Wrong -en suffix
ewefen	geweven	Wrong -en suffix
wefen	geweven	Wrong -en suffix
eweven	geweven	Prefix ge without onset
weven	geweven	Lacking ge prefix
wijkte	week	Overgeneralisation
wijkten	weken	Overgeneralisation
weekte	week	Irregular form plus regular suffix
weekten	weken	Irregular form plus regular suffix
gewijkt	geweken	Overgeneralisation
ewijkt	geweken	Overgeneralisation
wijkt	geweken	Overgeneralisation
sewijkt	geweken	Overgeneralisation+prefix ge pronounced as se
gewijkte	gewekene	Overgeneralisation+
ewijkte	gewekene	Overgeneralisation+Prefix ge without onset
sewijkte	gewekene	Overgeneralisation+prefix ge pronounced as se
gewijken	geweken	Wrong -en suffix
ewijken	geweken	Wrong -en suffix
wijken	geweken	Wrong -en suffix
geweekt	geweken	Overgeneralisation
eweken	geweken	Prefix ge without onset
weken	geweken	Lacking ge prefix
wijtte	weet	Overgeneralisation
wijtten	weten	Overgeneralisation
gewijt	geweten	Overgeneralisation
ewijt	geweten	Overgeneralisation
wijt	geweten	Overgeneralisation
sewijt	geweten	Overgeneralisation+prefix ge pronounced as se
gewijte	gewetene	Overgeneralisation+
ewijte	gewetene	Overgeneralisation+Prefix ge without onset
sewijte	gewetene	Overgeneralisation+prefix ge pronounced as se
gewijten	geweten	Wrong -en suffix
ewijten	geweten	Wrong -en suffix
wijten	geweten	Wrong -en suffix
wijsde	wees	Overgeneralisation
wijsden	wezen	Overgeneralisation
weesde	wees	Irregular form plus regular suffix
weesden	wezen	Irregular form plus regular suffix
gewijsd	gewezen	Overgeneralisation+
ewijsd	gewezen	Overgeneralisation+Prefix ge without onset
wijsd	gewezen	Overgeneralisation+Lacking ge prefix
sewijsd	gewezen	Overgeneralisation+prefix ge pronounced as se
gewijsde	gewezene	Overgeneralisation+
ewijsde	gewezene	Overgeneralisation+Prefix ge without onset
sewijsde	gewezene	Overgeneralisation+prefix ge pronounced as se
gewijst	gewezen	Overgeneralisation
ewijst	gewezen	Overgeneralisation
wijst	gewezen	Overgeneralisation
gewijsen	gewezen	Wrong -en suffix
ewijsen	gewezen	Wrong -en suffix
wijsen	gewezen	Wrong -en suffix
geweesd	gewezen	Overgeneralisation
geweest	gewezen	Overgeneralisation
ewezen	gewezen	Prefix ge without onset
wezen	gewezen	Lacking ge prefix
windde	wond	Overgeneralisation
windden	wonden	Overgeneralisation
wondde	wond	Irregular form plus regular suffix
wondden	wonden	Irregular form plus regular suffix
gewind	gewonnen	Overgeneralisation+
ewind	gewonnen	Overgeneralisation+Prefix ge without onset
wind	gewonnen	Overgeneralisation+Lacking ge prefix
sewind	gewonnen	Overgeneralisation+prefix ge pronounced as se
gewinde	gewonnene	Overgeneralisation+
ewinde	gewonnene	Overgeneralisation+Prefix ge without onset
sewinde	gewonnene	Overgeneralisation+prefix ge pronounced as se
gewinden	gewonden	Wrong -en suffix
ewinden	gewonden	Wrong -en suffix
winden	wonnen	Overgeneralisation
gewond	gewonden	Overgeneralisation
ewonden	gewonden	Prefix ge without onset
wonden	wonnen	Irregular form plus regular suffix
winde	won	Overgeneralisation
wonde	won	Irregular form plus regular suffix
gewint	gewonnen	Overgeneralisation
ewint	gewonnen	Overgeneralisation
wint	gewonnen	Overgeneralisation
gewinnen	gewonnen	Wrong -en suffix
ewinnen	gewonnen	Wrong -en suffix
winnen	gewonnen	Wrong -en suffix
gewont	gewonnen	Overgeneralisation
ewonnen	gewonnen	Prefix ge without onset
wonnen	gewonnen	Lacking ge prefix
wordde	werd	Overgeneralisation
wordden	werden	Overgeneralisation
werdde	werd	Irregular form plus regular suffix
werdden	werden	Irregular form plus regular suffix
geword	geworden	Overgeneralisation
eword	geworden	Overgeneralisation
word	geworden	Overgeneralisation
seword	geworden	Overgeneralisation+prefix ge pronounced as se
geworde	gewordene	Overgeneralisation+
eworde	gewordene	Overgeneralisation+Prefix ge without onset
seworde	gewordene	Overgeneralisation+prefix ge pronounced as se
eworden	geworden	Prefix ge without onset
worden	geworden	Lacking ge prefix
wrijfde	wreef	Overgeneralisation
wrijfden	wreven	Overgeneralisation
wreefde	wreef	Irregular form plus regular suffix
wreefden	wreven	Irregular form plus regular suffix
gewrijfd	gewreven	Overgeneralisation+
ewrijfd	gewreven	Overgeneralisation+Prefix ge without onset
wrijfd	gewreven	Overgeneralisation+Lacking ge prefix
sewrijfd	gewreven	Overgeneralisation+prefix ge pronounced as se
gewrijfde	gewrevene	Overgeneralisation+
ewrijfde	gewrevene	Overgeneralisation+Prefix ge without onset
sewrijfde	gewrevene	Overgeneralisation+prefix ge pronounced as se
gewrijft	gewreven	Overgeneralisation
ewrijft	gewreven	Overgeneralisation
wrijft	gewreven	Overgeneralisation
gewrijfen	gewreven	Wrong -en suffix
ewrijfen	gewreven	Wrong -en suffix
wrijfen	gewreven	Wrong -en suffix
gewreefd	gewreven	Overgeneralisation
gewreeft	gewreven	Overgeneralisation
ewreven	gewreven	Prefix ge without onset
wreven	gewreven	Lacking ge prefix
wringde	wrong	Overgeneralisation
wringden	wrongen	Overgeneralisation
wrongde	wrong	Irregular form plus regular suffix
wrongden	wrongen	Irregular form plus regular suffix
gewringd	gewrongen	Overgeneralisation+
ewringd	gewrongen	Overgeneralisation+Prefix ge without onset
wringd	gewrongen	Overgeneralisation+Lacking ge prefix
sewringd	gewrongen	Overgeneralisation+prefix ge pronounced as se
gewringde	gewrongene	Overgeneralisation+
ewringde	gewrongene	Overgeneralisation+Prefix ge without onset
sewringde	gewrongene	Overgeneralisation+prefix ge pronounced as se
gewringt	gewrongen	Overgeneralisation
ewringt	gewrongen	Overgeneralisation
wringt	gewrongen	Overgeneralisation
gewringen	gewrongen	Wrong -en suffix
ewringen	gewrongen	Wrong -en suffix
wringen	gewrongen	Wrong -en suffix
gewrongd	gewrongen	Overgeneralisation
gewrongt	gewrongen	Overgeneralisation
ewrongen	gewrongen	Prefix ge without onset
wrongen	gewrongen	Lacking ge prefix
zegde	zei	Overgeneralisation
zegden	zeiden	Overgeneralisation
zeide	zei	Irregular form plus regular suffix
ezegd	gezegd	Prefix ge without onset
zegd	gezegd	Lacking ge prefix
sezegd	gezegd	Overgeneralisation+prefix ge pronounced as se
ezegde	gezegde	Overgeneralisation+Prefix ge without onset
sezegde	gezegde	Overgeneralisation+prefix ge pronounced as se
gezegt	gezegd	Overgeneralisation
ezegt	gezegd	Overgeneralisation
zegt	gezegd	Overgeneralisation
gezeggen	gezegd	Wrong -en suffix
ezeggen	gezegd	Wrong -en suffix
zeggen	gezegd	Wrong -en suffix
zendde	zond	Overgeneralisation
zendden	zonden	Overgeneralisation
zondde	zond	Irregular form plus regular suffix
zondden	zonden	Irregular form plus regular suffix
gezend	gezonden	Overgeneralisation
ezend	gezonden	Overgeneralisation
zend	gezonden	Overgeneralisation
sezend	gezonden	Overgeneralisation+prefix ge pronounced as se
gezende	gezondene	Overgeneralisation+
ezende	gezondene	Overgeneralisation+Prefix ge without onset
sezende	gezondene	Overgeneralisation+prefix ge pronounced as se
gezenden	gezonden	Wrong -en suffix
ezenden	gezonden	Wrong -en suffix
zenden	gezonden	Wrong -en suffix
gezond	gezonden	Overgeneralisation
ezonden	gezonden	Prefix ge without onset
zonden	zonnen	Irregular form plus regular suffix
zijgde	zeeg	Overgeneralisation
zijgden	zegen	Overgeneralisation
zeegde	zeeg	Irregular form plus regular suffix
zeegden	zegen	Irregular form plus regular suffix
gezijgd	gezegen	Overgeneralisation+
ezijgd	gezegen	Overgeneralisation+Prefix ge without onset
zijgd	gezegen	Overgeneralisation+Lacking ge prefix
sezijgd	gezegen	Overgeneralisation+prefix ge pronounced as se
gezijgde	gezegene	Overgeneralisation+
ezijgde	gezegene	Overgeneralisation+Prefix ge without onset
sezijgde	gezegene	Overgeneralisation+prefix ge pronounced as se
gezijgt	gezegen	Overgeneralisation
ezijgt	gezegen	Overgeneralisation
zijgt	gezegen	Overgeneralisation
gezijgen	gezegen	Wrong -en suffix
ezijgen	gezegen	Wrong -en suffix
zijgen	gezegen	Wrong -en suffix
gezeegd	gezegen	Overgeneralisation
gezeegt	gezegen	Overgeneralisation
ezegen	gezegen	Prefix ge without onset
zegen	gezegen	Lacking ge prefix
zijde	was	Overgeneralisation
zijden	waren	Overgeneralisation
wasde	was	Irregular form plus regular suffix
wasden	waren	Irregular form plus regular suffix
gezijd	geweest	Overgeneralisation+
ezijd	geweest	Overgeneralisation+Prefix ge without onset
zijd	geweest	Overgeneralisation+Lacking ge prefix
sezijd	geweest	Overgeneralisation+prefix ge pronounced as se
gezijde	geweeste	Overgeneralisation+
ezijde	geweeste	Overgeneralisation+Prefix ge without onset
sezijde	geweeste	Overgeneralisation+prefix ge pronounced as se
gezijt	geweest	Overgeneralisation
ezijt	geweest	Overgeneralisation
zijt	geweest	Overgeneralisation
gezijjen	geweest	Wrong -en suffix
ezijjen	geweest	Wrong -en suffix
zijjen	geweest	Wrong -en suffix
eweest	geweest	Prefix ge without onset
weest	geweest	Lacking ge prefix
zingde	zong	Overgeneralisation
zingden	zongen	Overgeneralisation
zongde	zong	Irregular form plus regular suffix
zongden	zongen	Irregular form plus regular suffix
gezingd	gezongen	Overgeneralisation+
ezingd	gezongen	Overgeneralisation+Prefix ge without onset
zingd	gezongen	Overgeneralisation+Lacking ge prefix
sezingd	gezongen	Overgeneralisation+prefix ge pronounced as se
gezingde	gezongene	Overgeneralisation+
ezingde	gezongene	Overgeneralisation+Prefix ge without onset
sezingde	gezongene	Overgeneralisation+prefix ge pronounced as se
gezingt	gezongen	Overgeneralisation
ezingt	gezongen	Overgeneralisation
zingt	gezongen	Overgeneralisation
gezingen	gezongen	Wrong -en suffix
ezingen	gezongen	Wrong -en suffix
zingen	gezongen	Wrong -en suffix
gezongd	gezongen	Overgeneralisation
gezongt	gezongen	Overgeneralisation
ezongen	gezongen	Prefix ge without onset
zongen	gezongen	Lacking ge prefix
zinkte	zonk	Overgeneralisation
zinkten	zonken	Overgeneralisation
zonkte	zonk	Irregular form plus regular suffix
zonkten	zonken	Irregular form plus regular suffix
gezinkt	gezonken	Overgeneralisation
ezinkt	gezonken	Overgeneralisation
zinkt	gezonken	Overgeneralisation
sezinkt	gezonken	Overgeneralisation+prefix ge pronounced as se
gezinkte	gezonkene	Overgeneralisation+
ezinkte	gezonkene	Overgeneralisation+Prefix ge without onset
sezinkte	gezonkene	Overgeneralisation+prefix ge pronounced as se
gezinken	gezonken	Wrong -en suffix
ezinken	gezonken	Wrong -en suffix
zinken	gezonken	Wrong -en suffix
gezonkt	gezonken	Overgeneralisation
ezonken	gezonken	Prefix ge without onset
zonken	gezonken	Lacking ge prefix
zinde	zon	Overgeneralisation
zinden	zonnen	Overgeneralisation
zonde	zon	Irregular form plus regular suffix
gezind	gezonnen	Overgeneralisation+
ezind	gezonnen	Overgeneralisation+Prefix ge without onset
zind	gezonnen	Overgeneralisation+Lacking ge prefix
sezind	gezonnen	Overgeneralisation+prefix ge pronounced as se
gezinde	gezonnene	Overgeneralisation+
ezinde	gezonnene	Overgeneralisation+Prefix ge without onset
sezinde	gezonnene	Overgeneralisation+prefix ge pronounced as se
gezint	gezonnen	Overgeneralisation
ezint	gezonnen	Overgeneralisation
zint	gezonnen	Overgeneralisation
gezinnen	gezonnen	Wrong -en suffix
ezinnen	gezonnen	Wrong -en suffix
zinnen	gezonnen	Wrong -en suffix
gezont	gezonnen	Overgeneralisation
ezonnen	gezonnen	Prefix ge without onset
zonnen	gezonnen	Lacking ge prefix
zitte	zat	Overgeneralisation
zitten	gezeten	Wrong -en suffix
zatte	zat	Irregular form plus regular suffix
zatten	zaten	Irregular form plus regular suffix
gezit	gezeten	Overgeneralisation
ezit	gezeten	Overgeneralisation
zit	gezeten	Overgeneralisation
sezit	gezeten	Overgeneralisation+prefix ge pronounced as se
gezitte	gezetene	Overgeneralisation+
ezitte	gezetene	Overgeneralisation+Prefix ge without onset
sezitte	gezetene	Overgeneralisation+prefix ge pronounced as se
gezitten	gezeten	Wrong -en suffix
ezitten	gezeten	Wrong -en suffix
gezeet	gezeten	Overgeneralisation
ezeten	gezeten	Prefix ge without onset
zeten	gezeten	Lacking ge prefix
zoekte	zocht	Overgeneralisation
zoekten	zochten	Overgeneralisation
zochtte	zocht	Irregular form plus regular suffix
zochtten	zochten	Irregular form plus regular suffix
gezoekt	gezocht	Overgeneralisation
ezoekt	gezocht	Overgeneralisation
zoekt	gezocht	Overgeneralisation
sezoekt	gezocht	Overgeneralisation+prefix ge pronounced as se
gezoekte	gezochte	Overgeneralisation+
ezoekte	gezochte	Overgeneralisation+Prefix ge without onset
sezoekte	gezochte	Overgeneralisation+prefix ge pronounced as se
gezoeken	gezocht	Wrong -en suffix
ezoeken	gezocht	Wrong -en suffix
zoeken	gezocht	Wrong -en suffix
ezocht	gezocht	Prefix ge without onset
zocht	gezocht	Lacking ge prefix
zuigde	zoog	Overgeneralisation
zuigden	zogen	Overgeneralisation
zoogde	zoog	Irregular form plus regular suffix
zoogden	zogen	Irregular form plus regular suffix
gezuigd	gezogen	Overgeneralisation+
ezuigd	gezogen	Overgeneralisation+Prefix ge without onset
zuigd	gezogen	Overgeneralisation+Lacking ge prefix
sezuigd	gezogen	Overgeneralisation+prefix ge pronounced as se
gezuigde	gezogene	Overgeneralisation+
ezuigde	gezogene	Overgeneralisation+Prefix ge without onset
sezuigde	gezogene	Overgeneralisation+prefix ge pronounced as se
gezuigt	gezogen	Overgeneralisation
ezuigt	gezogen	Overgeneralisation
zuigt	gezogen	Overgeneralisation
gezuigen	gezogen	Wrong -en suffix
ezuigen	gezogen	Wrong -en suffix
zuigen	gezogen	Wrong -en suffix
gezoogt	gezogen	Overgeneralisation
ezogen	gezogen	Prefix ge without onset
zogen	gezogen	Lacking ge prefix
zuipte	zoop	Overgeneralisation
zuipten	zopen	Overgeneralisation
zoopte	zoop	Irregular form plus regular suffix
zoopten	zopen	Irregular form plus regular suffix
gezuipt	gezopen	Overgeneralisation
ezuipt	gezopen	Overgeneralisation
zuipt	gezopen	Overgeneralisation
sezuipt	gezopen	Overgeneralisation+prefix ge pronounced as se
gezuipte	gezopene	Overgeneralisation+
ezuipte	gezopene	Overgeneralisation+Prefix ge without onset
sezuipte	gezopene	Overgeneralisation+prefix ge pronounced as se
gezuipen	gezopen	Wrong -en suffix
ezuipen	gezopen	Wrong -en suffix
zuipen	gezopen	Wrong -en suffix
gezoopt	gezopen	Overgeneralisation
ezopen	gezopen	Prefix ge without onset
zopen	gezopen	Lacking ge prefix
zwelgde	zwolg	Overgeneralisation
zwelgden	zwolgen	Overgeneralisation
zwolgde	zwolg	Irregular form plus regular suffix
zwolgden	zwolgen	Irregular form plus regular suffix
gezwelgd	gezwolgen	Overgeneralisation+
ezwelgd	gezwolgen	Overgeneralisation+Prefix ge without onset
zwelgd	gezwolgen	Overgeneralisation+Lacking ge prefix
sezwelgd	gezwolgen	Overgeneralisation+prefix ge pronounced as se
gezwelgde	gezwolgene	Overgeneralisation+
ezwelgde	gezwolgene	Overgeneralisation+Prefix ge without onset
sezwelgde	gezwolgene	Overgeneralisation+prefix ge pronounced as se
gezwelgt	gezwolgen	Overgeneralisation
ezwelgt	gezwolgen	Overgeneralisation
zwelgt	gezwolgen	Overgeneralisation
gezwelgen	gezwolgen	Wrong -en suffix
ezwelgen	gezwolgen	Wrong -en suffix
zwelgen	gezwolgen	Wrong -en suffix
gezwolgd	gezwolgen	Overgeneralisation
gezwolgt	gezwolgen	Overgeneralisation
ezwolgen	gezwolgen	Prefix ge without onset
zwolgen	gezwolgen	Lacking ge prefix
zwelde	zwol	Overgeneralisation
zwelden	zwollen	Overgeneralisation
zwolde	zwol	Irregular form plus regular suffix
zwolden	zwollen	Irregular form plus regular suffix
gezweld	gezwollen	Overgeneralisation+
ezweld	gezwollen	Overgeneralisation+Prefix ge without onset
zweld	gezwollen	Overgeneralisation+Lacking ge prefix
sezweld	gezwollen	Overgeneralisation+prefix ge pronounced as se
gezwelde	gezwollene	Overgeneralisation+
ezwelde	gezwollene	Overgeneralisation+Prefix ge without onset
sezwelde	gezwollene	Overgeneralisation+prefix ge pronounced as se
gezwelt	gezwollen	Overgeneralisation
ezwelt	gezwollen	Overgeneralisation
zwelt	gezwollen	Overgeneralisation
gezwellen	gezwollen	Wrong -en suffix
ezwellen	gezwollen	Wrong -en suffix
zwellen	gezwollen	Wrong -en suffix
gezwolt	gezwollen	Overgeneralisation
ezwollen	gezwollen	Prefix ge without onset
zwollen	gezwollen	Lacking ge prefix
zwemde	zwom	Overgeneralisation
zwemden	zwommen	Overgeneralisation
zwomde	zwom	Irregular form plus regular suffix
zwomden	zwommen	Irregular form plus regular suffix
gezwemd	gezwommen	Overgeneralisation+
ezwemd	gezwommen	Overgeneralisation+Prefix ge without onset
zwemd	gezwommen	Overgeneralisation+Lacking ge prefix
sezwemd	gezwommen	Overgeneralisation+prefix ge pronounced as se
gezwemde	gezwommene	Overgeneralisation+
ezwemde	gezwommene	Overgeneralisation+Prefix ge without onset
sezwemde	gezwommene	Overgeneralisation+prefix ge pronounced as se
gezwemt	gezwommen	Overgeneralisation
ezwemt	gezwommen	Overgeneralisation
zwemt	gezwommen	Overgeneralisation
gezwemmen	gezwommen	Wrong -en suffix
ezwemmen	gezwommen	Wrong -en suffix
zwemmen	gezwommen	Wrong -en suffix
gezwomt	gezwommen	Overgeneralisation
ezwommen	gezwommen	Prefix ge without onset
zwommen	gezwommen	Lacking ge prefix
zweerde	zwoer	Overgeneralisation
zweerden	zwoeren	Overgeneralisation
zwoerde	zwoer	Irregular form plus regular suffix
zwoerden	zwoeren	Irregular form plus regular suffix
gezweerd	gezworen	Overgeneralisation+
ezweerd	gezworen	Overgeneralisation+Prefix ge without onset
zweerd	gezworen	Overgeneralisation+Lacking ge prefix
sezweerd	gezworen	Overgeneralisation+prefix ge pronounced as se
gezweerde	gezworene	Overgeneralisation+
ezweerde	gezworene	Overgeneralisation+Prefix ge without onset
sezweerde	gezworene	Overgeneralisation+prefix ge pronounced as se
gezweert	gezworen	Overgeneralisation
ezweert	gezworen	Overgeneralisation
zweert	gezworen	Overgeneralisation
gezweren	gezworen	Wrong -en suffix
ezweren	gezworen	Wrong -en suffix
zweren	gezworen	Wrong -en suffix
gezwoort	gezworen	Overgeneralisation
ezworen	gezworen	Prefix ge without onset
zworen	gezworen	Lacking ge prefix
zwerfde	zwierf	Overgeneralisation
zwerfden	zwierven	Overgeneralisation
zwierfde	zwierf	Irregular form plus regular suffix
zwierfden	zwierven	Irregular form plus regular suffix
gezwerfd	gezworven	Overgeneralisation+
ezwerfd	gezworven	Overgeneralisation+Prefix ge without onset
zwerfd	gezworven	Overgeneralisation+Lacking ge prefix
sezwerfd	gezworven	Overgeneralisation+prefix ge pronounced as se
gezwerfde	gezworvene	Overgeneralisation+
ezwerfde	gezworvene	Overgeneralisation+Prefix ge without onset
sezwerfde	gezworvene	Overgeneralisation+prefix ge pronounced as se
gezwerft	gezworven	Overgeneralisation
ezwerft	gezworven	Overgeneralisation
zwerft	gezworven	Overgeneralisation
gezwerfen	gezworven	Wrong -en suffix
ezwerfen	gezworven	Wrong -en suffix
zwerfen	gezworven	Wrong -en suffix
gezworfd	gezworven	Overgeneralisation
gezworft	gezworven	Overgeneralisation
ezworven	gezworven	Prefix ge without onset
zworven	gezworven	Lacking ge prefix
zwijgde	zweeg	Overgeneralisation
zwijgden	zwegen	Overgeneralisation
zweegde	zweeg	Irregular form plus regular suffix
zweegden	zwegen	Irregular form plus regular suffix
gezwijgd	gezwegen	Overgeneralisation+
ezwijgd	gezwegen	Overgeneralisation+Prefix ge without onset
zwijgd	gezwegen	Overgeneralisation+Lacking ge prefix
sezwijgd	gezwegen	Overgeneralisation+prefix ge pronounced as se
gezwijgde	gezwegene	Overgeneralisation+
ezwijgde	gezwegene	Overgeneralisation+Prefix ge without onset
sezwijgde	gezwegene	Overgeneralisation+prefix ge pronounced as se
gezwijgt	gezwegen	Overgeneralisation
ezwijgt	gezwegen	Overgeneralisation
zwijgt	gezwegen	Overgeneralisation
gezwijgen	gezwegen	Wrong -en suffix
ezwijgen	gezwegen	Wrong -en suffix
zwijgen	gezwegen	Wrong -en suffix
gezweegd	gezwegen	Overgeneralisation
gezweegt	gezwegen	Overgeneralisation
ezwegen	gezwegen	Prefix ge without onset
zwegen	gezwegen	Lacking ge prefix
